,Player,Class,Season,Pos,School,Conf,G,MP,FG,FGA,2P,2PA,3P,3PA,FT,FTA,ORB,DRB,TRB,AST,STL,BLK,TOV,PF,PTS
0,Jimmer Fredette,SR,2010-11,G,Brigham Young,MWC,37,1323,346,765,222,452,124,313,252,282,24,103,127,160,49,1,131,49,1068
1,Chris Clemons,SR,2018-19,G,Campbell,Big South,33,1208,304,679,165,290,139,389,246,283,25,142,167,94,49,11,84,63,993
2,Stephen Curry,JR,2008-09,G,Davidson,Southern,34,1145,312,687,182,351,130,336,220,251,21,130,151,189,86,8,126,81,974
3,Kemba Walker,JR,2010-11,G,Connecticut,Big East,41,1543,316,739,241,512,75,227,258,315,53,170,223,184,77,7,93,56,965
4,J.J. Redick,SR,2005-06,G,Duke,ACC,36,1336,302,643,163,313,139,330,221,256,7,64,71,95,52,2,90,54,964
5,Marcus Keene,JR,2016-17,G,Central Michigan,MAC,32,1179,313,700,188,360,125,340,208,254,22,121,143,156,26,0,145,63,959
6,Justin Wright-Foreman,SR,2018-19,G,Hofstra,CAA,35,1321,330,646,220,387,110,259,178,206,12,129,141,102,30,7,91,67,948
7,Trey Johnson,SR,2006-07,G,Jackson State,SWAC,35,1323,311,752,232,515,79,237,246,331,46,112,158,90,32,3,127,63,947
8,Reggie Hamilton,SR,2011-12,G,Oakland,Summit,36,1284,281,630,163,349,118,281,262,299,26,111,137,185,72,2,134,101,942
9,Doug McDermott,SR,2013-14,F,Creighton,Big East,35,1181,330,627,234,413,96,214,178,206,57,187,244,55,8,5,62,67,934
10,Stephen Curry,SO,2007-08,G,Davidson,Southern,36,1193,317,656,155,287,162,369,135,151,28,137,165,104,73,14,93,85,931
11,Reggie Williams,JR,2006-07,F,Virginia Military Institute,Big South,33,1070,338,636,262,398,76,238,176,267,110,153,263,146,55,10,98,67,928
12,Adam Morrison,JR,2005-06,F,Gonzaga,WCC,33,1205,306,617,232,444,74,173,240,311,47,135,182,56,35,11,76,66,926
13,Buddy Hield,SR,2015-16,G,Oklahoma,Big 12,37,1309,301,601,154,279,147,322,176,200,46,166,212,75,42,18,113,76,925
14,Stefon Jackson,SR,2008-09,G,Texas-El Paso,CUSA,37,1336,282,660,250,556,32,104,312,374,61,139,200,71,39,4,78,100,908
15,Chris Clemons,SO,2016-17,G,Campbell,Big South,36,1205,301,674,183,341,118,333,184,223,18,149,167,92,70,18,100,69,904
16,Kevin Durant,FR,2006-07,F,Texas,Big 12,35,1255,306,647,224,444,82,203,209,256,106,284,390,46,66,67,99,71,903
17,Aubrey Coleman,SR,2009-10,G,Houston,CUSA,35,1293,305,717,254,556,51,161,235,319,85,174,259,90,93,6,81,76,896
18,Tyler Hansbrough,JR,2007-08,F,North Carolina,ACC,39,1286,289,535,289,528,0,7,304,377,151,248,399,35,59,14,83,93,882
19,Jordan Howard,SR,2017-18,G,Central Arkansas,Southland,35,1259,280,613,167,326,113,287,207,233,10,115,125,93,36,0,80,41,880
22,Lester Hudson,SR,2008-09,G,Tennessee-Martin,OVC,32,1153,313,697,207,398,106,299,148,168,70,184,254,135,75,18,106,86,880
23,Mike Daum,SO,2016-17,F,South Dakota State,Summit,35,1143,274,533,195,344,79,189,251,289,76,209,285,49,20,15,98,87,878
24,Andrew Goudelock,SR,2010-11,G,College of Charleston,Southern,37,1302,318,699,187,377,131,322,110,134,25,118,143,157,33,7,119,66,877
25,Trae Young,FR,2017-18,G,Oklahoma,Big 12,32,1133,261,618,143,290,118,328,236,274,14,111,125,279,54,8,167,57,876
26,Carsen Edwards,JR,2018-19,G,Purdue,Big Ten,36,1275,277,703,142,323,135,380,185,221,14,116,130,104,48,10,113,73,874
27,T.J. Warren,SO,2013-14,F,North Carolina State,ACC,35,1238,342,652,311,536,31,116,156,226,113,137,250,40,63,21,83,97,871
28,Michael Beasley,FR,2007-08,F,Kansas State,Big 12,33,1041,307,577,271,482,36,95,216,279,131,277,408,38,42,54,95,85,866
29,R.J. Barrett,FR,2018-19,F,Duke,ACC,38,1341,319,702,246,465,73,237,149,224,59,229,288,164,34,16,123,70,860
30,Andre Spight,SR,2017-18,G,Northern Colorado,Big Sky,38,1285,293,661,165,341,128,320,141,180,20,128,148,139,44,10,112,73,855
31,Jermaine Marrow,JR,2018-19,G,Hampton,Big South,35,1275,274,649,186,411,88,238,218,269,26,116,142,171,56,6,111,110,854
32,Jodie Meeks,JR,2008-09,G,Kentucky,SEC,36,1237,263,568,146,280,117,288,211,234,19,103,122,63,48,5,96,69,854
33,Kay Felder,JR,2015-16,G,Oakland,Horizon,35,1286,269,612,193,398,76,214,239,282,26,123,149,324,69,7,120,104,853
34,Markus Howard,JR,2018-19,G,Marquette,Big East,34,1138,252,600,132,302,120,298,227,255,14,121,135,133,36,1,134,72,851
35,Lester Hudson,JR,2007-08,G,Tennessee-Martin,OVC,33,1219,291,627,167,307,124,320,141,169,72,187,259,148,94,22,126,87,847
36,Antoine Mason,JR,2013-14,G,Niagara,MAAC,33,1242,269,612,221,444,48,168,260,357,32,86,118,51,40,5,91,95,846
37,Morris Almond,SR,2006-07,G,Rice,CUSA,32,1069,263,544,186,375,77,169,241,285,43,167,210,37,38,24,109,68,844
38,Keydren Clark,SR,2005-06,G,Saint Peter's,MAAC,32,1243,273,694,168,372,105,322,189,212,42,90,132,140,80,8,102,60,840
39,Quincy Douby,JR,2005-06,G,Rutgers,Big East,33,1211,287,621,171,332,116,289,149,176,27,114,141,103,58,27,92,61,839
40,Trey Freeman,SR,2015-16,G,Old Dominion,CUSA,38,1333,323,753,272,607,51,146,141,170,21,139,160,115,39,4,48,68,838
41,Mike Daum,JR,2017-18,F,South Dakota State,Summit,35,1090,273,591,177,365,96,226,194,228,64,295,359,45,17,26,72,84,836
44,Mike Daum,SR,2018-19,F,South Dakota State,Summit,33,1099,286,559,219,378,67,181,196,234,78,307,385,58,24,32,73,95,835
45,Doug McDermott,JR,2012-13,F,Creighton,MVC,36,1138,284,518,207,361,77,157,189,216,58,218,276,57,8,2,93,56,834
46,David Holston,SR,2008-09,G,Chicago State,Ind,32,1118,269,632,122,237,147,395,145,176,32,87,119,204,97,0,131,68,830
47,Billy Baron,SR,2013-14,G,Canisius,MAAC,34,1325,247,532,140,278,107,254,220,249,17,149,166,180,56,1,101,38,821
48,Lamine Diane,FR,2018-19,F,Cal State Northridge,Big West,33,1165,340,701,333,678,7,23,131,251,108,260,368,68,50,72,105,112,818
49,Jon Elmore,JR,2017-18,G,Marshall,CUSA,36,1380,243,554,145,279,98,275,232,281,16,194,210,244,58,13,132,56,816
50,James Daniel,JR,2015-16,G,Howard,MEAC,30,1115,226,582,146,341,80,241,280,331,22,44,66,84,59,7,123,62,812
51,Dallas Moore,SR,2016-17,G,North Florida,A-Sun,34,1192,299,613,199,362,100,251,114,138,26,81,107,135,39,3,82,39,812
52,Jermaine Taylor,SR,2008-09,G,Central Florida,CUSA,31,989,291,606,199,361,92,245,138,170,59,102,161,58,39,24,87,55,812
53,Gary Neal,SR,2006-07,G,Towson,CAA,32,1167,267,599,174,321,93,278,183,219,28,107,135,111,46,5,74,66,810
54,Ja Morant,SO,2018-19,G,Murray State,OVC,33,1207,265,531,208,374,57,157,221,272,40,148,188,331,58,27,170,48,808
55,Erick Green,SR,2012-13,G,Virginia Tech,ACC,32,1166,261,550,200,393,61,157,218,267,15,112,127,121,42,6,69,44,801
56,Doug McDermott,SO,2011-12,F,Creighton,MVC,35,1117,307,511,253,400,54,111,133,167,84,204,288,37,7,3,79,61,801
57,Rob McKiver,SR,2007-08,G,Houston,CUSA,34,1183,233,588,88,212,145,376,190,215,18,113,131,99,56,2,86,65,801
58,Charron Fisher,SR,2007-08,F,Niagara,MAAC,29,1084,256,645,187,428,69,217,219,284,92,183,275,34,49,18,89,75,800
59,Blake Griffin,SO,2008-09,F,Oklahoma,Big 12,35,1165,300,459,297,451,3,8,191,324,135,369,504,80,39,41,116,89,794
60,Reggie Holmes,SR,2009-10,G,Morgan State,MEAC,37,1226,226,583,126,304,100,279,241,294,56,102,158,31,57,6,74,88,793
61,Luke Harangody,JR,2008-09,F,Notre Dame,Big East,34,1164,300,653,286,615,14,38,178,229,120,281,401,70,31,31,62,77,792
62,Marshon Brooks,SR,2010-11,G,Providence,Big East,32,1168,276,571,209,374,67,197,169,219,72,153,225,80,48,39,98,80,788
63,Jaycee Carroll,SR,2007-08,G,Utah State,WAC,35,1304,267,508,153,279,114,229,137,149,56,153,209,76,33,7,70,65,785
66,Antoine Davis,FR,2018-19,G,Detroit Mercy,Horizon,30,1122,263,657,131,310,132,347,126,147,22,72,94,107,28,0,99,70,784
67,Damian Lillard,JR,2011-12,G,Weber State,Big Sky,32,1105,231,495,137,265,94,230,228,257,17,144,161,128,47,7,74,62,784
68,Myles Powell,JR,2018-19,G,Seton Hall,Big East,34,1225,252,564,145,269,107,295,173,206,26,110,136,99,68,6,101,76,784
69,RJ Cole,FR,2017-18,G,Howard,MEAC,33,1252,241,612,132,308,109,304,191,248,27,103,130,200,57,0,127,87,782
70,Steve Burtt,SR,2005-06,G,Iona,MAAC,31,1103,258,579,162,343,96,236,168,204,18,85,103,79,22,2,98,72,780
71,Norris Cole,SR,2010-11,G,Cleveland State,Horizon,36,1285,251,572,200,423,51,149,227,266,27,183,210,191,80,3,97,87,780
72,Tyler Haws,SO,2012-13,G,Brigham Young,WCC,36,1235,276,571,233,458,43,113,185,211,49,116,165,71,45,5,71,54,780
73,Randy Onwuasor,JR,2016-17,G,Southern Utah,Big Sky,33,1155,253,619,194,426,59,193,215,260,52,165,217,107,50,14,113,104,780
74,Grayson Allen,SO,2015-16,G,Duke,ACC,36,1317,239,513,149,297,90,216,211,252,24,141,165,127,47,5,72,98,779
75,Alec Burks,SO,2010-11,G,Colorado,Big 12,38,1193,251,535,223,439,28,96,249,302,91,156,247,112,41,12,99,89,779
76,Stefon Jackson,JR,2007-08,G,Texas-El Paso,CUSA,33,1158,261,562,226,457,35,105,221,303,56,132,188,57,39,3,77,77,778
77,Kendrick Nunn,SR,2017-18,G,Oakland,Horizon,30,1136,262,602,128,262,134,340,119,142,27,115,142,113,45,11,88,67,777
78,Anthony Barber,JR,2015-16,G,North Carolina State,ACC,33,1278,248,572,205,453,43,119,237,274,21,130,151,147,21,2,85,71,776
79,Tyler Haws,SR,2014-15,G,Brigham Young,WCC,35,1125,258,538,204,391,54,147,206,236,46,110,156,83,33,9,69,48,776
80,Bo McCalebb,JR,2006-07,G,New Orleans,Sun Belt,31,1071,287,601,261,523,26,78,176,248,76,135,211,101,62,5,88,86,776
81,Chris Clemons,JR,2017-18,G,Campbell,Big South,31,1055,233,515,138,259,95,256,211,245,10,132,142,95,49,10,83,58,772
82,MoMo Jones,SR,2012-13,G,Iona,MAAC,34,1246,246,561,190,383,56,178,221,249,24,77,101,116,40,2,114,73,769
83,Tyler Haws,JR,2013-14,G,Brigham Young,WCC,33,1143,252,544,212,445,40,99,223,253,33,93,126,49,34,9,63,75,767
84,Kevin Foster,SO,2010-11,G,Santa Clara,WCC,38,1221,229,594,89,214,140,380,168,210,14,90,104,141,61,5,117,90,766
85,C.J. McCollum,JR,2011-12,G,Lehigh,Patriot,35,1160,254,573,194,397,60,176,198,244,50,179,229,124,91,19,81,73,766
88,Ben Woodside,SR,2008-09,G,North Dakota State,Summit,33,1137,234,504,167,347,67,157,231,275,9,97,106,204,47,5,104,44,766
89,Rashawn Thomas,SR,2016-17,F,Texas A&M-Corpus Christi,Southland,34,1145,268,511,254,474,14,37,215,298,78,227,305,92,53,69,126,118,765
90,Josh Akognon,SR,2008-09,G,Cal State Fullerton,Big West,32,1140,248,618,112,252,136,366,132,148,18,83,101,51,32,1,84,63,764
91,Nolan Smith,SR,2010-11,G,Duke,ACC,37,1259,260,568,203,405,57,163,187,230,44,122,166,189,45,3,118,72,764
92,Bryce Cotton,SR,2013-14,G,Providence,Big East,35,1398,230,549,153,339,77,210,226,265,19,105,124,205,35,3,85,51,763
93,Jock Landale,JR,2017-18,C,Saint Mary's (CA),WCC,36,1200,301,470,298,460,3,10,156,209,106,260,366,72,14,36,84,109,761
94,Eric Maynor,SR,2008-09,G,Virginia Commonwealth,CAA,34,1206,248,536,182,353,66,183,198,243,16,106,122,210,58,6,101,82,760
95,Jalen Brunson,JR,2017-18,G,Villanova,Big East,40,1272,270,518,184,307,86,211,130,162,12,110,122,184,37,1,71,78,756
96,Justin Wright-Foreman,JR,2017-18,G,Hofstra,CAA,31,1171,264,588,168,326,96,262,131,164,10,93,103,100,25,7,69,62,755
97,Malik Monk,FR,2016-17,G,Kentucky,SEC,38,1218,251,558,147,296,104,262,148,180,12,83,95,87,36,19,75,72,754
98,Donald Sims,JR,2009-10,G,Appalachian State,Southern,37,1273,228,499,105,211,123,288,175,184,9,108,117,84,33,1,90,43,754
99,Frank Mason,SR,2016-17,G,Kansas,Big 12,36,1301,241,492,159,318,82,174,189,238,22,128,150,187,47,2,86,73,753
100,D.J. Balentine,SO,2013-14,G,Evansville,MVC,33,1252,229,528,151,332,78,196,216,255,16,72,88,139,19,4,84,56,752
101,Jordan Davis,SR,2018-19,G,Northern Colorado,Big Sky,32,1082,256,540,202,390,54,150,186,231,29,121,150,149,45,10,107,73,752
102,Toney Douglas,SR,2008-09,G,Florida State,ACC,35,1279,239,536,154,315,85,221,188,232,28,109,137,102,63,15,87,76,751
103,Jimmer Fredette,JR,2009-10,G,Brigham Young,MWC,34,1059,225,491,148,316,77,175,224,251,25,80,105,159,41,5,93,36,751
104,Trey Johnson,JR,2005-06,G,Jackson State,SWAC,32,1114,255,560,188,408,67,152,174,232,52,103,155,73,46,2,86,71,751
105,Fletcher Magee,JR,2017-18,G,Wofford,Southern,34,1143,253,523,105,186,148,337,97,107,9,91,100,58,31,3,57,62,751
106,Jon Elmore,SR,2018-19,G,Marshall,CUSA,37,1330,234,595,120,282,114,313,168,213,11,178,189,187,64,20,114,74,750
107,Garrison Mathews,SR,2018-19,G,Lipscomb,A-Sun,36,1082,222,501,106,213,116,288,190,221,25,172,197,70,30,9,82,68,750
108,Russ Smith,JR,2012-13,G,Louisville,Big East,40,1211,232,560,170,371,62,189,222,276,41,91,132,116,83,2,108,102,748
109,Jaycee Carroll,JR,2006-07,G,Utah State,WAC,35,1255,256,486,173,294,83,192,151,170,80,140,220,62,31,7,88,76,746
110,Charles Jenkins,SR,2010-11,G,Hofstra,CAA,33,1232,249,482,183,325,66,157,182,221,18,93,111,158,57,22,73,66,746
111,Bryson Scott,SR,2017-18,G,Purdue-Fort Wayne,Summit,33,1026,247,541,197,372,50,169,202,247,20,128,148,86,65,5,91,65,746
112,Zion Williamson,FR,2018-19,F,Duke,ACC,33,990,296,435,272,364,24,71,130,203,116,177,293,68,70,59,78,68,746
113,Joe Young,SR,2014-15,G,Oregon,Pac-12,36,1322,265,592,174,337,91,255,124,134,19,141,160,135,41,1,87,51,745
114,Luke Babbitt,SO,2009-10,F,Nevada,WAC,34,1260,251,502,209,401,42,101,199,217,70,233,303,72,35,27,81,87,743
115,Kelan Martin,SR,2017-18,F,Butler,Big East,35,1249,259,580,164,319,95,261,130,154,33,186,219,70,26,16,84,67,743
116,Adrian Oliver,SR,2010-11,G,San Jose State,WAC,31,1086,246,569,176,398,70,171,181,220,39,126,165,78,23,12,96,85,743
117,Bo McCalebb,SR,2007-08,G,New Orleans,Sun Belt,32,1065,261,516,214,400,47,116,173,224,50,93,143,99,76,3,74,85,742
118,Arizona Reid,SR,2007-08,F,High Point,Big South,31,1093,304,571,270,481,34,90,100,134,105,237,342,75,54,16,65,87,742
119,D'Marcus Simonds,SO,2017-18,G,Georgia State,Sun Belt,35,1223,277,601,235,457,42,144,146,208,46,155,201,153,60,24,127,100,742
120,Roosevelt Smart,SO,2017-18,G,North Texas,CUSA,38,1274,221,557,88,205,133,352,167,188,17,141,158,35,23,10,65,86,742
121,Bogdan Bliznyuk,SR,2017-18,G,Eastern Washington,Big Sky,35,1228,265,502,220,389,45,113,166,184,33,205,238,137,29,10,119,83,741
122,Derrick Williams,SO,2010-11,F,Arizona,Pac-10,38,1141,226,380,184,306,42,74,247,331,105,209,314,43,37,26,100,106,741
123,Josh Adams,SR,2015-16,G,Wyoming,MWC,31,1125,217,492,121,238,96,254,210,254,18,155,173,134,44,18,115,86,740
124,Tyler Hall,SO,2016-17,G,Montana State,Big Sky,32,1101,240,504,120,224,120,280,139,166,17,155,172,90,34,12,65,78,739
125,Marcus Thornton,SR,2008-09,G,Louisiana State,SEC,35,1116,256,542,178,341,78,201,149,200,71,121,192,75,56,13,64,72,739
126,Ben Bentil,SO,2015-16,F,Providence,Big East,35,1198,246,533,194,375,52,158,194,248,94,174,268,40,30,36,67,97,738
127,Tyler Harvey,JR,2014-15,G,Eastern Washington,Big Sky,32,1182,230,490,102,193,128,297,150,176,20,96,116,82,36,4,64,60,738
130,Aaric Murray,SR,2013-14,C,Texas Southern,SWAC,34,1088,241,491,210,399,31,92,223,301,74,181,255,41,29,86,89,88,736
131,Kyle Wiltjer,SR,2015-16,F,Gonzaga,WCC,36,1209,260,529,170,323,90,206,126,147,61,167,228,53,13,29,74,66,736
132,James Anderson,JR,2009-10,G,Oklahoma State,Big 12,33,1124,226,494,152,277,74,217,209,258,64,128,192,80,46,20,78,88,735
133,Courtney Lee,SR,2007-08,G,Western Kentucky,Sun Belt,36,1079,259,543,190,369,69,174,148,180,48,127,175,75,65,28,84,87,735
134,Nate Wolters,SR,2012-13,G,South Dakota State,Summit,33,1256,242,499,178,330,64,169,187,230,36,148,184,193,57,4,77,51,735
135,Nick Mayo,SR,2018-19,F,Eastern Kentucky,OVC,31,1079,245,530,191,367,54,163,190,220,70,201,271,70,38,55,85,83,734
136,Klay Thompson,JR,2010-11,G,Washington State,Pac-10,34,1179,240,551,142,305,98,246,155,185,25,153,178,127,56,32,115,99,733
137,Cassius Winston,JR,2018-19,G,Michigan State,Big Ten,39,1308,243,528,159,317,84,211,163,194,13,104,117,291,40,4,114,75,733
138,Kevin Foster,SR,2012-13,G,Santa Clara,WCC,38,1233,241,602,121,267,120,335,130,166,15,88,103,165,91,5,131,90,732
139,Frank Kaminsky,SR,2014-15,C,Wisconsin,Big Ten,39,1311,267,488,225,387,42,101,156,200,58,262,320,103,33,57,63,65,732
140,Tyler Nelson,SR,2017-18,G,Fairfield,MAAC,33,1205,230,547,126,252,104,295,168,191,18,120,138,110,45,3,82,55,732
141,D.J. Augustin,SO,2007-08,G,Texas,Big 12,38,1417,242,551,168,357,74,194,173,221,20,92,112,219,47,0,105,61,731
142,Andre Collins,SR,2005-06,G,Loyola (MD),MAAC,28,1066,256,619,138,297,118,322,101,112,21,79,100,131,67,4,104,65,731
143,Justin Jackson,JR,2016-17,F,North Carolina,ACC,40,1281,264,596,159,312,105,284,98,131,58,128,186,113,31,9,69,55,731
144,Sam Merrill,JR,2018-19,G,Utah State,MWC,35,1237,228,495,142,266,86,229,189,208,12,126,138,147,37,10,66,86,731
145,Stefan Moody,SR,2015-16,G,Mississippi,SEC,31,1072,208,509,105,237,103,272,212,256,31,69,100,133,46,3,118,75,731
146,Deshaun Thomas,JR,2012-13,F,Ohio State,Big Ten,37,1309,259,583,187,374,72,209,141,169,63,157,220,48,19,11,52,54,731
147,Travis Bader,JR,2012-13,G,Oakland,Summit,33,1261,206,523,67,163,139,360,179,202,12,83,95,32,30,2,47,93,730
148,Stephen Curry,FR,2006-07,G,Davidson,Southern,34,1049,242,523,120,224,122,299,124,145,32,125,157,95,62,6,95,87,730
149,Alan Daniels,SR,2005-06,F,Lamar,Southland,31,1089,250,574,175,327,75,247,155,233,59,148,207,92,72,21,76,76,730
152,Rui Hachimura,JR,2018-19,F,Gonzaga,WCC,37,1117,275,465,260,429,15,36,164,222,52,188,240,56,35,27,68,74,729
153,Kevin Tiggs,SR,2008-09,F,East Tennessee State,A-Sun,34,1150,248,469,211,364,37,105,196,256,63,99,162,68,72,8,104,75,729
154,RJ Cole,SO,2018-19,G,Howard,MEAC,34,1209,218,525,134,308,84,217,208,254,24,116,140,218,64,1,110,76,728
155,Jack Gibbs,JR,2015-16,G,Davidson,A-10,31,1099,244,565,162,320,82,245,158,188,28,100,128,152,56,2,100,59,728
156,Brice Johnson,SR,2015-16,F,North Carolina,ACC,40,1121,287,465,287,465,0,0,154,194,115,301,416,58,43,59,70,106,728
157,Jon Scheyer,SR,2009-10,G,Duke,ACC,40,1470,212,531,102,244,110,287,194,221,31,113,144,194,65,10,65,54,728
158,Cameron Young,SR,2018-19,G,Quinnipiac,MAAC,31,1113,222,461,118,223,104,238,180,235,31,128,159,58,35,9,89,69,728
159,Trey Burke,SO,2012-13,G,Michigan,Big Ten,39,1378,259,560,183,362,76,198,133,166,21,103,124,260,62,20,86,73,727
160,Jeremy Hazell,SO,2008-09,G,Seton Hall,Big East,32,1161,235,550,130,260,105,290,151,204,41,81,122,29,56,1,69,63,726
161,Rodney Stuckey,FR,2005-06,G,Eastern Washington,Big Sky,30,990,250,510,195,362,55,148,171,225,32,112,144,123,66,8,107,75,726
162,Tony Carr,SO,2017-18,G,Penn State,Big Ten,37,1308,245,600,157,397,88,203,147,184,33,150,183,186,30,11,85,68,725
163,Marvelle Harris,SR,2015-16,G,Fresno State,MWC,35,1284,240,589,174,386,66,203,179,238,19,144,163,156,76,21,77,102,725
164,Jerome Robinson,JR,2017-18,G,Boston College,ACC,35,1260,249,513,168,315,81,198,146,176,17,109,126,116,30,5,96,88,725
165,Chris Douglas-Roberts,JR,2007-08,G,Memphis,CUSA,40,1147,259,479,214,370,45,109,161,226,53,112,165,71,49,18,83,68,724
166,Chasson Randle,SR,2014-15,G,Stanford,Pac-12,37,1347,217,539,127,291,90,248,200,228,11,112,123,112,50,5,75,82,724
167,Grant Riller,JR,2018-19,G,College of Charleston,CAA,33,1172,264,491,218,351,46,140,150,186,19,94,113,134,41,2,79,56,724
168,Omar Samhan,SR,2009-10,C,Saint Mary's (CA),WCC,34,1098,282,510,282,509,0,1,160,220,119,250,369,34,15,99,72,102,724
169,D.J. Balentine,JR,2014-15,G,Evansville,MVC,36,1318,245,563,171,374,74,189,159,212,18,96,114,116,29,7,78,35,723
170,Drake Reed,SR,2008-09,F,Austin Peay,OVC,33,1211,275,487,258,441,17,46,156,209,84,165,249,78,24,19,83,66,723
171,Jonathan Stark,JR,2016-17,G,Murray State,OVC,33,1207,249,568,141,314,108,254,117,141,9,119,128,172,43,1,95,75,723
174,Marshall Henderson,JR,2012-13,G,Mississippi,SEC,36,1134,209,549,71,155,138,394,166,188,17,94,111,63,48,2,76,59,722
175,Luke Kennard,SO,2016-17,G,Duke,ACC,37,1314,237,485,149,284,88,201,160,187,43,145,188,91,31,13,59,83,722
176,Nick Fazekas,JR,2005-06,F,Nevada,WAC,33,1051,268,507,237,400,31,107,154,182,100,242,342,68,36,49,59,59,721
177,Nate Wolters,JR,2011-12,G,South Dakota State,Summit,34,1216,250,558,217,421,33,137,188,240,31,143,174,202,59,2,75,63,721
178,Jamal Murray,FR,2015-16,G,Kentucky,SEC,36,1267,244,538,131,261,113,277,119,152,53,133,186,79,35,11,84,75,720
179,Shabazz Napier,SR,2013-14,G,Connecticut,AAC,40,1404,213,496,126,281,87,215,207,238,38,196,234,195,73,13,114,84,720
180,Jeremy Senglin,SR,2016-17,G,Weber State,Big Sky,34,1198,233,490,101,195,132,295,121,158,6,125,131,96,38,1,81,73,719
181,Jordan Crawford,SO,2009-10,G,Xavier,A-10,35,1147,260,563,181,361,79,202,119,154,34,132,166,101,47,7,85,57,718
182,Joel Hernandez,JR,2017-18,G,Long Island University,NEC,35,1152,256,555,198,400,58,155,148,223,65,138,203,90,19,17,104,90,718
183,Georges Niang,SR,2015-16,F,Iowa State,Big 12,35,1162,283,518,227,375,56,143,96,119,46,172,218,117,31,22,92,111,718
184,Ty Cockfield,SR,2018-19,G,Arkansas State,Sun Belt,32,1122,237,540,168,346,69,194,173,211,26,88,114,103,36,4,94,65,716
185,Jordan Ford,JR,2018-19,G,Saint Mary's (CA),WCC,34,1255,255,521,185,351,70,170,136,170,17,78,95,85,43,1,65,57,716
186,Andrew Rowsey,SR,2017-18,G,Marquette,Big East,35,1143,208,495,83,194,125,301,175,194,14,91,105,169,32,7,99,83,716
187,Zach Thomas,SR,2017-18,F,Bucknell,Patriot,35,1113,206,446,143,281,63,165,241,310,45,272,317,74,35,24,103,71,716
188,Alando Tucker,SR,2006-07,G,Wisconsin,Big Ten,36,1181,256,545,216,422,40,123,164,249,78,118,196,73,33,10,60,45,716
189,Keon Johnson,SR,2016-17,G,Winthrop,Big South,32,1124,221,511,119,256,102,255,171,197,14,113,127,83,22,0,74,60,715
190,Garrison Mathews,JR,2017-18,G,Lipscomb,A-Sun,33,1003,213,458,123,222,90,236,199,249,41,139,180,58,32,9,71,83,715
191,Jacob Pullen,JR,2009-10,G,Kansas State,Big 12,37,1168,201,480,91,202,110,278,203,247,16,80,96,125,67,2,93,89,715
192,Robert Glenn,SR,2009-10,F,IUPUI,Summit,36,1118,259,446,254,423,5,23,191,253,74,166,240,62,44,50,109,105,714
193,David Kool,SR,2009-10,G,Western Michigan,MAC,33,1155,221,492,158,316,63,176,209,233,35,100,135,87,58,0,73,53,714
196,Andrew Andrews,SR,2015-16,G,Washington,Pac-12,34,1150,181,461,104,269,77,192,273,321,50,145,195,165,47,1,95,96,712
197,Tyus Battle,SO,2017-18,G,Syracuse,ACC,37,1443,234,586,157,347,77,239,167,199,17,91,108,76,54,7,87,74,712
198,Pierre Jackson,SR,2012-13,G,Baylor,Big 12,36,1252,216,506,128,261,88,245,192,240,24,111,135,255,54,0,122,80,712
199,Patrick Miller,JR,2013-14,G,Tennessee State,OVC,30,1132,230,514,186,383,44,131,208,268,45,89,134,123,49,5,100,88,712
200,Rodney Stuckey,SO,2006-07,G,Eastern Washington,Big Sky,29,965,227,501,184,340,43,161,215,254,35,100,135,160,71,9,98,68,712
201,Cameron Morse,JR,2016-17,G,Youngstown State,Horizon,31,1123,260,627,184,389,76,238,115,156,16,84,100,96,32,3,66,44,711
202,Zeek Woodley,SO,2014-15,G,Northwestern State,Southland,32,1009,262,468,223,370,39,98,148,182,55,105,160,34,33,22,38,73,711
203,Karvel Anderson,SR,2013-14,G,Robert Morris,NEC,36,1100,248,486,129,229,119,257,95,113,27,93,120,50,48,8,44,72,710
204,Ty Greene,SR,2014-15,G,South Carolina Upstate,A-Sun,35,1191,232,522,129,269,103,253,142,189,30,78,108,74,74,7,45,56,709
205,Fletcher Magee,SR,2018-19,G,Wofford,Southern,35,1098,225,513,67,136,158,377,101,111,13,76,89,55,26,3,49,50,709
206,Jeremy Ingram,SR,2013-14,G,North Carolina Central,MEAC,34,1170,212,483,144,299,68,184,216,280,33,97,130,41,54,22,70,90,708
207,Jeremiah Martin,SR,2018-19,G,Memphis,AAC,36,1230,220,488,154,297,66,191,202,265,39,114,153,157,79,23,95,69,708
208,James Palmer,SR,2018-19,G,Nebraska,Big Ten,36,1266,213,578,146,364,67,214,215,282,39,111,150,107,52,14,77,78,708
209,Seth Curry,FR,2008-09,G,Liberty,Big South,35,1277,243,583,141,289,102,294,119,143,24,129,153,79,48,9,79,53,707
210,Cameron Payne,SO,2014-15,G,Murray State,OVC,35,1127,245,537,161,314,84,223,133,169,21,108,129,209,68,17,87,72,707
211,Kyle Singler,JR,2009-10,F,Duke,ACC,40,1436,228,550,143,337,85,213,166,208,90,190,280,96,41,32,79,86,707
212,Mikal Bridges,JR,2017-18,G,Villanova,Big East,40,1285,244,475,140,236,104,239,114,134,54,158,212,77,61,43,54,86,706
213,Justin James,SR,2018-19,G,Wyoming,MWC,32,1221,228,557,178,388,50,169,200,270,32,241,273,141,48,18,133,68,706
214,Shane Gibson,JR,2011-12,G,Sacred Heart,NEC,32,1082,253,496,166,295,87,201,112,130,25,124,149,70,48,11,101,91,705
215,Dominique Jones,JR,2009-10,G,South Florida,Big East,33,1224,222,493,170,326,52,167,209,282,37,164,201,120,56,19,97,93,705
216,Max Strus,SR,2018-19,G,DePaul,Big East,35,1309,232,541,119,230,113,311,128,152,39,168,207,77,33,17,70,103,705
217,Deandre Ayton,FR,2017-18,F,Arizona,Pac-12,35,1172,276,451,264,416,12,35,140,191,118,287,405,57,20,66,69,81,704
218,D.J. Covington,SR,2013-14,F,Virginia Military Institute,Big South,35,1040,268,452,268,450,0,2,168,241,94,232,326,29,34,106,74,108,704
219,Jarrett Culver,SO,2018-19,G,Texas Tech,Big 12,38,1234,254,551,205,390,49,161,147,208,54,189,243,142,57,21,103,73,704
220,LaceDarius Dunn,JR,2009-10,G,Baylor,Big 12,36,1174,231,513,115,236,116,277,126,147,30,143,173,67,49,11,91,108,704
221,Landry Fields,SR,2009-10,G,Stanford,Pac-10,32,1161,248,506,219,420,29,86,179,257,81,199,280,89,51,25,83,65,704
222,Tyler Hansbrough,SR,2008-09,F,North Carolina,ACC,34,1029,223,434,214,411,9,23,249,296,103,173,276,34,42,12,63,77,704
223,James Harden,SO,2008-09,G,Arizona State,Pac-10,35,1254,221,452,163,289,58,163,204,270,48,147,195,148,59,11,118,99,704
224,D.J. Newbill,SR,2014-15,G,Penn State,Big Ten,34,1261,243,540,182,375,61,165,157,207,37,123,160,105,44,7,90,73,704
225,Shawn Glover,SR,2013-14,F,Oral Roberts,Southland,33,1151,273,547,248,495,25,52,132,159,42,150,192,49,28,53,72,67,703
226,Junior Robinson,SR,2017-18,G,Mount St. Mary's,NEC,32,1162,228,511,150,310,78,201,169,188,19,73,92,154,37,1,89,87,703
227,C.J. Burks,JR,2017-18,G,Marshall,CUSA,35,1256,260,551,174,315,86,236,96,108,18,126,144,107,36,4,108,74,702
228,Charles Jenkins,JR,2009-10,G,Hofstra,CAA,34,1234,235,531,172,377,63,154,169,210,38,116,154,134,61,19,108,89,702
229,Dylan Windler,SR,2018-19,G,Belmont,OVC,33,1097,243,450,143,217,100,233,116,137,64,293,357,84,47,19,69,69,702
230,Peyton Aldridge,SR,2017-18,F,Davidson,A-10,33,1245,252,526,175,324,77,202,120,141,46,205,251,82,13,20,40,51,701
231,Bogdan Bliznyuk,JR,2016-17,F,Eastern Washington,Big Sky,34,1251,251,529,213,409,38,120,161,196,36,186,222,136,36,7,104,92,701
232,Sean Kilpatrick,SR,2013-14,G,Cincinnati,AAC,34,1149,214,506,121,239,93,267,180,213,36,110,146,86,48,1,70,46,701
233,Dedric Lawson,JR,2018-19,F,Kansas,Big 12,36,1175,249,508,214,419,35,89,167,205,111,260,371,61,45,38,83,94,700
234,Devan Downey,SR,2009-10,G,South Carolina,SEC,31,1055,237,592,168,390,69,202,156,187,17,85,102,108,85,1,109,72,699
235,Tyler Hansbrough,SO,2006-07,F,North Carolina,ACC,38,1136,228,434,227,430,1,4,242,315,117,184,301,45,41,17,74,90,699
238,Adrian Oliver,JR,2009-10,G,San Jose State,WAC,31,1119,230,526,179,401,51,125,188,212,49,115,164,89,30,15,99,92,699
239,D.J. Balentine,SR,2015-16,G,Evansville,MVC,34,1253,240,543,182,372,58,171,160,204,26,87,113,148,24,9,92,58,698
240,Jabari Brown,JR,2013-14,G,Missouri,SEC,35,1295,203,435,123,240,80,195,212,266,17,138,155,67,22,5,82,57,698
241,Gary Forbes,SR,2007-08,F,Massachusetts,A-10,36,1214,233,572,176,377,57,195,175,243,65,205,270,109,41,25,113,87,698
242,Caleb Green,SR,2006-07,F,Oral Roberts,Mid-Cont,34,1184,207,413,201,396,6,17,278,366,95,220,315,87,47,12,135,99,698
243,JaJuan Johnson,SR,2010-11,F,Purdue,Big Ten,34,1203,257,520,242,469,15,51,169,209,82,209,291,33,30,79,56,53,698
244,Ryan Anderson,SO,2007-08,F,University of California,Pac-10,33,1082,230,469,166,313,64,156,173,199,100,228,328,47,12,18,74,71,697
245,Khalif Wyatt,SR,2012-13,G,Temple,A-10,34,1136,209,501,134,264,75,237,204,244,14,84,98,135,58,7,106,75,697
246,John Jenkins,JR,2011-12,G,Vanderbilt,SEC,35,1177,217,458,83,153,134,305,128,153,16,85,101,42,29,11,55,42,696
247,Grant Williams,JR,2018-19,F,Tennessee,SEC,37,1181,234,415,219,369,15,46,213,260,82,196,278,117,42,55,83,110,696
248,Adrian Banks,JR,2006-07,G,Arkansas State,Sun Belt,33,1219,232,468,135,264,97,204,134,183,25,119,144,63,29,3,85,39,695
249,Quincy Pondexter,SR,2009-10,F,Washington,Pac-10,36,1162,245,464,227,413,18,51,187,226,107,158,265,63,46,21,68,90,695
250,Robert Vaden,JR,2007-08,G,Alabama-Birmingham,CUSA,33,1170,220,539,78,184,142,355,113,131,14,102,116,85,32,7,97,65,695
251,Reggie Williams,SR,2007-08,F,Virginia Military Institute,Big South,25,878,269,509,226,355,43,154,114,170,93,149,242,97,55,17,76,53,695
252,Marvin Bagley III,FR,2017-18,F,Duke,ACC,33,1118,270,440,247,382,23,58,131,209,132,234,366,50,27,29,75,60,694
253,Cameron Bairstow,SR,2013-14,F,New Mexico,MWC,34,1119,237,426,236,423,1,3,219,298,76,175,251,53,19,51,68,72,694
254,Cane Broome,SO,2015-16,G,Sacred Heart,NEC,30,1126,236,530,170,318,66,212,156,203,17,131,148,88,51,0,115,71,694
255,Elijah Brown,SO,2015-16,G,New Mexico,MWC,32,1077,194,453,105,227,89,226,217,255,22,154,176,101,35,2,108,64,694
256,Markus Howard,SO,2017-18,G,Marquette,Big East,34,1071,239,515,128,240,111,275,105,112,13,95,108,94,33,2,85,85,694
257,Nick King,SR,2017-18,F,Middle Tennessee,CUSA,33,1086,259,523,217,415,42,108,134,183,78,200,278,65,23,7,94,50,694
260,Jason Thompson,SR,2007-08,C,Rider,MAAC,34,1177,275,491,264,457,11,34,133,229,114,298,412,93,36,91,99,100,694
261,Jacob Wiley,SR,2016-17,F,Eastern Washington,Big Sky,34,1165,265,412,260,405,5,7,159,192,95,214,309,80,26,94,128,102,694
262,Jerel McNeal,SR,2008-09,G,Marquette,Big East,35,1226,236,534,150,318,86,216,135,183,28,131,159,137,71,21,103,87,693
263,Justin Robinson,JR,2015-16,G,Monmouth,MAAC,36,1184,214,488,134,285,80,203,185,219,21,115,136,132,79,0,80,55,693
264,Kahlil Dukes,SR,2017-18,G,Niagara,MAAC,33,1120,224,482,129,254,95,228,149,164,6,66,72,108,27,1,83,56,692
265,Austin McBroom,SR,2015-16,G,Eastern Washington,Big Sky,33,1235,212,488,97,202,115,286,153,184,21,63,84,121,35,0,93,52,692
266,Jordan McRae,SR,2013-14,G,Tennessee,SEC,37,1190,223,512,144,287,79,225,167,212,26,102,128,91,25,38,77,78,692
267,Thomas Robinson,JR,2011-12,F,Kansas,Big 12,39,1242,261,517,254,503,7,14,163,239,113,350,463,72,42,34,104,107,692
268,Jon Elmore,JR,2016-17,G,Marshall,CUSA,35,1230,210,508,127,272,83,236,188,233,21,131,152,207,40,7,109,63,691
269,Shan Foster,SR,2007-08,G,Vanderbilt,SEC,34,1147,242,463,108,177,134,286,73,96,39,128,167,56,36,8,58,66,691
270,Eric Mika,SO,2016-17,F,Brigham Young,WCC,34,974,233,441,233,440,0,1,225,295,104,208,312,56,19,63,84,92,691
271,Pascal Siakam,SO,2015-16,F,New Mexico State,WAC,34,1176,275,510,272,495,3,15,137,202,132,263,395,58,34,75,67,92,690
272,Terrell Stoglin,SO,2011-12,G,Maryland,ACC,32,1045,220,533,129,296,91,237,159,202,17,93,110,62,23,3,71,66,690
273,Al Thornton,SR,2006-07,G,Florida State,ACC,35,1092,244,460,208,379,36,81,166,210,106,145,251,24,53,40,87,95,690
274,Sam Young,SR,2008-09,F,Pittsburgh,Big East,36,1146,261,520,207,375,54,145,114,154,69,156,225,40,35,30,88,60,690
275,Jaylon Brown,SR,2016-17,G,Evansville,MVC,33,1215,220,475,182,386,38,89,211,246,16,129,145,101,34,3,82,80,689
276,Marcus Marshall,SR,2016-17,G,Nevada,MWC,35,1240,205,487,90,184,115,303,164,198,12,75,87,128,30,2,60,72,689
277,Gerardo Suero,JR,2011-12,G,Albany (NY),AEC,32,1015,220,479,191,398,29,81,220,265,68,116,184,100,42,11,134,82,689
278,Jahmar Young,JR,2009-10,G,New Mexico State,WAC,34,1182,228,497,155,302,73,195,160,191,15,105,120,107,27,7,92,88,689
279,George Hill,JR,2007-08,G,IUPUI,Summit,32,1179,220,404,171,295,49,109,199,245,49,167,216,137,57,13,94,89,688
282,R.J. Hunter,JR,2014-15,G,Georgia State,Sun Belt,35,1294,203,514,123,252,80,262,202,230,27,138,165,126,75,35,77,85,688
283,Anthony Ireland,JR,2012-13,G,Loyola Marymount,WCC,34,1274,228,552,163,379,65,173,167,203,42,107,149,121,58,1,112,71,688
284,Talor Battle,SR,2010-11,G,Penn State,Big Ten,34,1294,225,532,119,245,106,287,131,175,16,134,150,100,26,3,67,52,687
285,Devon Beitzel,SR,2010-11,G,Northern Colorado,Big Sky,32,1134,201,421,114,200,87,221,198,219,11,94,105,56,44,1,77,56,687
286,Matt Morgan,SR,2018-19,G,Cornell,Ivy,31,1000,215,419,112,180,103,239,154,179,7,134,141,93,43,9,104,63,687
287,Carsen Edwards,SO,2017-18,G,Purdue,Big Ten,37,1092,229,500,132,261,97,239,131,159,13,129,142,104,42,8,64,65,686
288,Andrew Gonzalez,JR,2010-11,F,Houston Baptist,GWC,30,1111,204,491,146,342,58,149,220,270,47,119,166,67,47,14,104,70,686
289,Caleb Green,JR,2005-06,F,Oral Roberts,Mid-Cont,33,1062,224,425,221,415,3,10,235,308,123,167,290,53,34,11,96,94,686
290,Bubba Parham,SO,2018-19,G,Virginia Military Institute,Southern,32,1085,210,494,94,202,116,292,150,189,10,99,109,112,20,1,82,60,686
291,A.J. English,JR,2014-15,G,Iona,MAAC,34,1272,212,491,106,217,106,274,155,197,26,148,174,172,49,18,128,91,685
292,Marcus Evans,FR,2015-16,G,Rice,CUSA,32,1073,223,474,171,304,52,170,187,235,28,100,128,91,70,6,100,92,685
293,Jack Gibbs,SR,2016-17,G,Davidson,A-10,31,1122,215,503,121,263,94,240,161,202,22,103,125,127,41,0,82,77,685
294,Colt Ryan,SR,2012-13,G,Evansville,MVC,34,1121,219,517,156,357,63,160,184,206,25,96,121,137,50,2,74,75,685
295,Jonathan Stark,SR,2017-18,G,Murray State,OVC,32,1165,221,490,111,214,110,276,133,149,12,73,85,126,43,6,78,56,685
296,Stephen Madison,SR,2013-14,F,Idaho,WAC,34,1172,218,457,179,337,39,120,209,275,70,190,260,81,34,17,93,101,684
297,O.J. Mayo,FR,2007-08,G,Southern California,Pac-10,33,1216,237,536,149,321,88,215,122,152,35,115,150,109,51,13,117,80,684
298,J'Covan Brown,JR,2011-12,G,Texas,Big 12,34,1209,223,535,143,318,80,217,157,182,30,85,115,130,41,4,92,66,683
299,Jimmy Hall,SR,2016-17,F,Kent State,MAC,36,1172,267,513,264,493,3,20,146,188,148,235,383,91,32,48,104,105,683
300,Noah Dahlman,SR,2010-11,F,Wofford,Southern,34,1065,255,417,255,416,0,1,172,227,94,98,192,41,26,12,41,75,682
301,Michael Glover,JR,2010-11,F,Iona,MAAC,37,1269,260,426,260,423,0,3,162,260,138,236,374,34,28,34,85,102,682
304,Jerrick Harding,SO,2017-18,G,Weber State,Big Sky,31,1019,249,470,192,336,57,134,127,144,19,87,106,53,33,5,74,57,682
305,Adnan Hodzic,JR,2009-10,C,Lipscomb,A-Sun,30,970,269,445,269,445,0,0,144,213,103,169,272,23,14,12,80,66,682
306,Andrew Kostecka,JR,2018-19,G,Loyola (MD),Patriot,32,1064,241,461,193,335,48,126,152,187,39,115,154,76,85,29,89,99,682
307,Kendrick Perry,SR,2013-14,G,Youngstown State,Horizon,32,1168,215,425,153,251,62,174,190,258,29,103,132,140,76,10,60,85,682
308,Reid Travis,JR,2017-18,F,Stanford,Pac-12,35,1190,250,474,232,413,18,61,164,243,104,202,306,47,26,4,72,91,682
309,Travis Bader,SR,2013-14,G,Oakland,Horizon,33,1242,185,479,38,119,147,360,164,174,10,81,91,47,29,3,43,100,681
310,Chavis Holmes,SR,2008-09,G,Virginia Military Institute,Big South,31,1029,212,414,129,226,83,188,174,210,55,89,144,96,105,33,70,81,681
311,Kevin Love,FR,2007-08,C,UCLA,Pac-10,39,1156,227,406,198,324,29,82,198,258,142,273,415,75,27,56,78,73,681
312,Kevin Murphy,SR,2011-12,G,Tennessee Tech,OVC,33,1139,239,538,160,348,79,190,124,172,30,143,173,76,28,7,108,71,681
313,Caleb Martin,JR,2017-18,F,Nevada,MWC,36,1199,223,491,123,243,100,248,134,179,34,160,194,92,45,21,61,95,680
314,Larry Blair,JR,2005-06,G,Liberty,Big South,30,1101,234,579,170,399,64,180,147,184,25,115,140,80,61,11,79,57,679
315,Yoeli Childs,JR,2018-19,F,Brigham Young,WCC,32,1066,258,509,226,410,32,99,131,185,65,244,309,66,31,33,88,84,679
316,Alec Peters,JR,2015-16,F,Valparaiso,Horizon,37,1186,223,442,132,235,91,207,142,167,93,219,312,49,26,11,63,77,679
317,Braylon Rayson,SR,2016-17,G,Central Michigan,MAC,32,1191,209,549,116,291,93,258,168,198,25,115,140,101,39,1,86,69,679
318,Davon Usher,SR,2013-14,G,Delaware,CAA,35,1282,216,479,131,245,85,234,162,218,51,161,212,62,62,14,71,91,679
319,Marquez Haynes,SR,2009-10,G,Texas-Arlington,Southland,30,999,215,445,152,291,63,154,185,248,23,105,128,112,46,10,107,63,678
320,Anthony Lamb,JR,2018-19,F,Vermont,AEC,32,1011,242,470,192,333,50,137,144,189,55,195,250,72,29,62,69,63,678
321,Luwane Pipkins,SO,2017-18,G,Massachusetts,A-10,32,1114,228,530,121,279,107,251,115,146,15,99,114,128,48,0,108,68,678
322,Randy Foye,SR,2005-06,G,Villanova,Big East,33,1145,226,550,137,296,89,254,136,172,54,136,190,100,46,21,71,71,677
323,Greg Gantt,SR,2012-13,G,Florida Atlantic,Sun Belt,32,1175,235,550,151,333,84,217,123,155,22,111,133,44,25,3,78,48,677
324,Tyler Harvey,SO,2013-14,G,Eastern Washington,Big Sky,31,1158,206,465,97,213,109,252,156,174,21,108,129,84,35,9,66,71,677
325,Jarrius Jackson,SR,2006-07,G,Texas Tech,Big 12,34,1293,224,517,145,336,79,181,150,190,33,79,112,60,46,0,47,55,677
326,C.J. McCollum,SO,2010-11,G,Lehigh,Patriot,31,1073,214,537,162,372,52,165,197,233,59,183,242,66,77,21,88,53,677
327,Isaiah Pineiro,SR,2018-19,F,San Diego,WCC,36,1249,232,476,192,357,40,119,173,211,68,271,339,76,44,19,107,119,677
328,Shelden Williams,SR,2005-06,F,Duke,ACC,36,1198,237,410,235,404,2,6,201,270,117,267,384,39,60,137,89,114,677
329,Trevon Bluiett,SR,2017-18,G,Xavier,Big East,35,1200,202,462,97,210,105,252,167,197,29,164,193,87,26,9,70,76,676
330,Isaiah Canaan,SR,2012-13,G,Murray State,OVC,31,1131,215,499,121,245,94,254,152,185,19,91,110,133,47,4,98,58,676
331,Kevin Hervey,SR,2017-18,F,Texas-Arlington,Sun Belt,33,1064,243,545,166,318,77,227,113,140,77,205,282,73,41,20,90,60,676
332,Chris Horton,SR,2015-16,C,Austin Peay,OVC,36,1213,248,414,248,414,0,0,180,290,177,254,431,54,49,63,98,76,676
333,Malcolm Brogdon,SR,2015-16,G,Virginia,ACC,37,1263,230,503,155,311,75,192,140,156,19,131,150,115,35,9,52,76,675
334,Devonte' Graham,SR,2017-18,G,Kansas,Big 12,39,1474,199,498,89,227,110,271,167,202,24,133,157,282,62,2,109,56,675
335,Chasson Randle,JR,2013-14,G,Stanford,Pac-12,36,1263,218,460,150,285,68,175,171,223,20,109,129,77,37,2,88,93,675
336,D'Angelo Russell,FR,2014-15,G,Ohio State,Big Ten,35,1188,231,515,136,284,95,231,118,156,35,163,198,175,55,11,102,74,675
337,Terry Taylor,SO,2018-19,G,Austin Peay,OVC,33,1092,258,486,208,339,50,147,109,147,111,183,294,57,35,30,64,66,675
338,Randy Culpepper,SR,2010-11,G,Texas-El Paso,CUSA,35,1261,227,521,161,317,66,204,154,203,22,80,102,107,71,10,82,85,674
339,Orlando Johnson,JR,2010-11,G,UC-Santa Barbara,Big West,32,1065,222,467,156,304,66,163,164,204,49,149,198,94,39,16,87,67,674
340,David Laury,SR,2014-15,F,Iona,MAAC,34,1201,244,514,217,443,27,71,159,233,85,244,329,96,27,45,101,92,674
341,Dominique Morrison,SR,2011-12,F,Oral Roberts,Summit,34,1240,215,441,160,311,55,130,189,229,34,113,147,55,28,12,57,100,674
342,Jerrelle Benimon,SR,2013-14,F,Towson,CAA,36,1307,225,425,211,381,14,44,209,293,84,320,404,130,25,44,124,104,673
343,Chase Fischer,SR,2015-16,G,Brigham Young,WCC,37,1257,209,509,97,204,112,305,143,173,14,88,102,77,41,2,55,63,673
346,Josh Hart,SR,2016-17,G,Villanova,Big East,36,1193,236,463,162,280,74,183,127,170,51,179,230,106,56,10,71,81,673
347,John Holland,JR,2009-10,F,Boston University,AEC,35,1205,215,468,155,300,60,168,183,215,59,155,214,37,56,10,72,116,673
348,Daishon Smith,SR,2018-19,G,Louisiana-Monroe,Sun Belt,32,1108,195,440,85,165,110,275,173,201,22,121,143,126,69,2,70,58,673
349,Russ Smith,SR,2013-14,G,Louisville,AAC,37,1084,225,481,155,300,70,181,153,217,29,93,122,172,74,4,105,92,673
350,Charles Williams,SO,2017-18,F,Howard,MEAC,33,1173,253,567,179,386,74,181,93,119,23,89,112,19,28,10,58,72,673
351,Keita Bates-Diop,JR,2017-18,F,Ohio State,Big Ten,34,1125,247,515,181,331,66,184,112,141,52,244,296,56,31,56,62,57,672
352,Luke Harangody,SO,2007-08,F,Notre Dame,Big East,33,958,259,518,256,509,3,9,151,198,116,235,351,55,26,29,76,85,672
353,Markis McDuffie,SR,2018-19,F,Wichita State,AAC,37,1235,214,525,130,279,84,246,160,196,66,118,184,37,38,7,61,72,672
354,Dallas Moore,JR,2015-16,G,North Florida,A-Sun,34,1211,256,496,192,334,64,162,96,135,20,115,135,205,31,5,64,28,672
355,Elfrid Payton,JR,2013-14,G,Louisiana,Sun Belt,35,1258,237,466,223,412,14,54,184,302,81,129,210,208,80,21,127,83,672
356,Jordan Hamilton,SO,2010-11,G,Texas,Big 12,36,1159,243,552,153,318,90,234,95,122,72,204,276,76,31,23,77,64,671
357,Aaron Holiday,JR,2017-18,G,UCLA,Pac-12,33,1244,212,460,124,255,88,205,159,192,17,104,121,192,42,8,125,87,671
358,Amere May,SR,2014-15,G,Delaware State,MEAC,32,1095,227,543,138,313,89,230,128,156,32,101,133,85,32,6,93,57,671
359,Arizona Reid,JR,2006-07,F,High Point,Big South,32,1061,285,560,265,502,20,58,81,123,100,204,304,60,38,15,91,91,671
360,Dionte Christmas,JR,2007-08,G,Temple,A-10,34,1266,210,478,106,196,104,282,146,189,43,159,202,86,46,7,96,90,670
361,T.J. Cromer,SR,2016-17,G,East Tennessee State,Southern,35,1110,224,491,118,230,106,261,116,141,16,83,99,111,36,14,97,83,670
362,Nick Dixon,SR,2017-18,G,Texas-Rio Grande Valley,WAC,33,978,197,440,143,287,54,153,222,279,52,94,146,78,47,6,82,63,670
363,Jabari Parker,FR,2013-14,F,Duke,ACC,35,1074,236,499,198,393,38,106,160,214,105,201,306,41,37,43,81,83,670
364,Victor Sanders,JR,2016-17,G,Idaho,Big Sky,32,1052,206,453,105,223,101,230,157,201,12,94,106,106,55,11,103,91,670
365,Jeremy Combs,SR,2018-19,F,Texas Southern,SWAC,38,1203,242,402,237,381,5,21,180,305,142,210,352,56,59,23,92,121,669
368,Glen Davis,SO,2005-06,F,Louisiana State,SEC,36,1144,250,505,244,482,6,23,163,241,145,205,350,50,47,41,96,89,669
369,Obi Emegano,JR,2015-16,G,Oral Roberts,Summit,29,1026,210,484,159,350,51,134,198,232,28,121,149,53,33,10,51,69,669
370,Eric Gordon,FR,2007-08,G,Indiana,Big Ten,32,1110,184,425,114,217,70,208,231,277,23,81,104,78,42,20,115,69,669
371,LaDontae Henton,SR,2014-15,F,Providence,Big East,34,1257,230,516,166,327,64,189,145,191,60,162,222,29,46,16,68,76,669
372,Whit Holcomb-Faye,SR,2005-06,G,Radford,Big South,29,1108,202,511,119,263,83,248,182,225,16,67,83,116,33,2,86,69,669
373,Justin Robinson,SR,2016-17,G,Monmouth,MAAC,34,1128,212,508,116,270,96,238,149,174,20,109,129,162,49,3,89,54,669
374,Phil Booth,SR,2018-19,G,Villanova,Big East,36,1265,218,502,123,243,95,259,137,183,13,127,140,137,30,7,84,70,668
375,Sam Young,JR,2007-08,F,Pittsburgh,Big East,37,1187,254,505,210,390,44,115,116,168,83,149,232,45,41,42,87,73,668
376,Malcolm Delaney,JR,2009-10,G,Virginia Tech,ACC,33,1183,187,483,124,277,63,206,230,273,30,92,122,147,41,3,99,96,667
377,Martaveous McKnight,SR,2018-19,G,Arkansas-Pine Bluff,SWAC,32,1177,226,511,152,320,74,191,141,199,22,138,160,94,48,11,87,39,667
378,Sandy Cohen,SR,2018-19,G,Green Bay,Horizon,38,1297,219,461,161,289,58,172,170,220,19,225,244,177,71,40,118,97,666
379,Michael Deloach,SR,2008-09,G,Norfolk State,MEAC,31,1154,244,536,209,430,35,106,143,200,50,101,151,86,63,8,114,91,666
380,James Florence,JR,2008-09,G,Mercer,A-Sun,32,1091,229,547,166,334,63,213,145,208,25,88,113,119,72,2,123,81,666
381,Stan Okoye,SR,2012-13,F,Virginia Military Institute,Big South,31,1010,236,523,177,362,59,161,135,202,79,211,290,82,47,13,100,67,666
382,Alec Peters,SR,2016-17,F,Valparaiso,Horizon,29,1019,218,468,160,308,58,160,172,194,74,219,293,64,23,11,71,64,666
383,Brandon Roy,SR,2005-06,G,Washington,Pac-10,33,1046,228,449,189,352,39,97,171,211,69,117,186,135,46,26,75,81,666
384,Trevon Bluiett,JR,2016-17,G,Xavier,Big East,36,1263,212,484,121,239,91,245,150,199,26,178,204,75,32,4,78,86,665
385,Marcus Evans,SO,2016-17,G,Rice,CUSA,35,1110,197,464,111,235,86,229,185,235,14,101,115,131,40,5,128,92,665
386,Jairus Lyles,SR,2017-18,G,Maryland-Baltimore County,AEC,33,1152,225,512,147,312,78,200,137,173,23,160,183,117,68,6,103,65,665
387,Semi Ojeleye,JR,2016-17,F,Southern Methodist,AAC,35,1195,210,431,137,259,73,172,172,219,80,160,240,53,15,14,50,62,665
390,Donte Clark,SR,2017-18,G,Texas Southern,SWAC,36,1252,203,506,161,357,42,149,216,279,39,148,187,93,39,12,102,113,664
391,QJ Peterson,FR,2013-14,G,Virginia Military Institute,Big South,35,1152,218,549,140,305,78,244,150,198,63,133,196,72,59,12,76,81,664
392,Jonny Flynn,SO,2008-09,G,Syracuse,Big East,38,1418,219,476,174,334,45,142,180,229,22,82,104,254,54,6,129,55,663
393,Jhivvan Jackson,SO,2018-19,G,Texas-San Antonio,CUSA,29,894,222,575,118,279,104,296,115,136,13,105,118,71,35,2,68,80,663
394,James Kelly,SR,2015-16,F,Marshall,CUSA,33,1009,260,479,211,320,49,159,94,126,61,263,324,38,44,36,77,94,663
395,Zach Lofton,SR,2017-18,G,New Mexico State,WAC,33,1054,217,476,130,247,87,229,142,184,37,129,166,56,35,4,71,67,663
396,Roberto Nelson,SR,2013-14,G,Oregon State,Pac-12,32,1052,200,447,143,304,57,143,206,250,35,73,108,115,31,1,98,70,663
397,Demetris Nichols,SR,2006-07,F,Syracuse,Big East,35,1217,225,503,125,263,100,240,113,133,50,140,190,54,49,37,77,73,663
398,Saah Nimley,SR,2014-15,G,Charleston Southern,Big South,31,1106,183,477,73,170,110,307,187,228,17,110,127,126,28,1,85,68,663
399,Sindarius Thornwell,SR,2016-17,G,South Carolina,SEC,31,1051,195,439,137,291,58,148,215,259,77,144,221,86,66,30,76,71,663
400,Dionte Christmas,SR,2008-09,G,Temple,A-10,34,1191,218,527,111,223,107,304,119,158,36,161,197,98,51,5,98,85,662
401,Erik Kangas,SR,2008-09,G,Oakland,Summit,35,1259,222,505,87,181,135,324,83,94,23,80,103,61,38,6,67,50,662
402,Lamond Murray,SR,2016-17,G,Pepperdine,WCC,31,1060,251,528,200,394,51,134,109,140,36,140,176,40,35,12,81,64,662
403,Warren Niles,SR,2012-13,G,Oral Roberts,Southland,35,1277,222,507,126,264,96,243,122,154,24,121,145,55,41,6,69,69,662
404,Artsiom Parakhouski,SR,2009-10,C,Radford,Big South,31,1076,250,430,247,418,3,12,159,283,160,254,414,33,19,65,75,69,662
405,Sherron Collins,JR,2008-09,G,Kansas,Big 12,35,1229,226,521,149,316,77,205,132,166,19,82,101,174,39,0,115,67,661
406,Justin Harper,SR,2010-11,F,Richmond,A-10,37,1178,245,459,168,287,77,172,94,118,62,194,256,43,23,46,56,82,661
407,Reggie Larry,SR,2007-08,F,Boise State,WAC,34,1169,244,455,207,369,37,86,136,213,84,229,313,62,48,35,90,67,661
408,John Shurna,SR,2011-12,F,Northwestern,Big Ten,33,1232,228,492,133,276,95,216,110,146,48,130,178,92,41,54,52,56,661
409,Rodney Glasgow,SR,2013-14,G,Virginia Military Institute,Big South,35,1291,232,483,146,266,86,217,110,126,32,107,139,205,46,0,62,61,660
412,Jelani Hewitt,JR,2013-14,G,Georgia Southern,Southern,34,1152,211,520,126,284,85,236,153,184,31,120,151,104,75,5,103,78,660
413,Maurice Kemp,SR,2012-13,F,East Carolina,CUSA,35,1202,231,457,215,399,16,58,182,241,87,193,280,85,61,39,67,80,660
414,J.J. Mann,SR,2013-14,G,Belmont,OVC,36,1266,218,474,129,246,89,228,135,155,15,157,172,92,77,3,61,51,660
415,Nolan Smith,JR,2009-10,G,Duke,ACC,38,1349,239,542,179,389,60,153,122,159,35,71,106,114,47,9,70,67,660
416,Alex Young,SO,2009-10,G,IUPUI,Summit,36,1136,242,496,170,314,72,182,104,155,49,114,163,43,54,22,79,103,660
417,Eugene German,SO,2017-18,G,Northern Illinois,MAC,32,991,243,516,181,333,62,183,111,145,13,110,123,54,28,5,66,53,659
418,Marcelus Kemp,SR,2007-08,G,Nevada,WAC,33,1058,222,494,152,310,70,184,145,168,43,136,179,109,23,10,81,63,659
419,Colbey Ross,SO,2018-19,G,Pepperdine,WCC,34,1187,179,410,116,251,63,159,238,279,12,88,100,239,41,5,147,93,659
420,Marcus Thornton,SR,2014-15,G,William & Mary,CAA,33,1210,215,472,113,218,102,254,127,153,9,83,92,95,21,4,77,36,659
421,Andrew Goudelock,JR,2009-10,G,College of Charleston,Southern,34,1210,250,554,153,307,97,247,61,74,25,123,148,131,38,13,68,58,658
422,Jonathan Wade,SR,2016-17,G,Norfolk State,MEAC,34,1187,217,448,156,289,61,159,163,218,53,178,231,63,22,3,110,73,658
423,Jarron Cumberland,JR,2018-19,G,Cincinnati,AAC,35,1136,207,512,127,306,80,206,163,211,40,115,155,127,40,14,96,80,657
424,Tyler Hall,SR,2018-19,G,Montana State,Big Sky,32,1071,233,521,117,213,116,308,75,90,21,130,151,89,35,9,68,61,657
425,Aaron Jackson,SR,2008-09,G,Duquesne,A-10,34,1249,229,413,182,297,47,116,152,188,61,125,186,194,56,3,103,63,657
426,Jarrius Jackson,JR,2005-06,G,Texas Tech,Big 12,32,1228,216,496,143,333,73,163,152,187,21,109,130,93,53,2,67,41,657
427,Kevin Jones,SR,2011-12,F,West Virginia,Big East,33,1265,260,511,226,383,34,128,103,132,141,219,360,41,23,34,42,41,657
428,Brandon Knight,FR,2010-11,G,Kentucky,SEC,38,1363,217,513,130,282,87,231,136,171,25,128,153,159,25,8,120,83,657
429,Jahlil Okafor,FR,2014-15,C,Duke,ACC,38,1143,279,420,279,420,0,0,99,194,134,188,322,49,29,54,95,81,657
430,Maurice Ager,SR,2005-06,G,Michigan State,Big Ten,34,1170,226,495,143,274,83,221,121,159,24,115,139,84,23,11,87,81,656
431,Peyton Aldridge,JR,2016-17,F,Davidson,A-10,32,1180,233,471,163,300,70,171,120,144,54,209,263,70,28,28,53,65,656
432,Jordan Caroline,JR,2017-18,G,Nevada,MWC,37,1290,221,466,185,355,36,111,178,251,98,221,319,82,26,6,71,87,656
433,Ricky Harris,SO,2007-08,G,Massachusetts,A-10,36,1174,209,488,105,210,104,278,134,178,19,71,90,63,56,5,73,74,656
434,Donovan Morris,JR,2007-08,G,Long Beach State,Big West,31,1164,202,438,127,258,75,180,177,209,28,133,161,72,26,10,105,39,656
435,Kendrick Ray,SR,2016-17,G,Kennesaw State,A-Sun,31,1049,244,543,158,325,86,218,82,104,30,84,114,97,22,10,81,75,656
436,Colt Ryan,JR,2011-12,G,Evansville,MVC,32,1161,199,450,125,281,74,169,184,218,14,120,134,105,60,7,78,85,656
437,Devon Saddler,JR,2012-13,G,Delaware,CAA,33,1246,216,505,160,339,56,166,168,205,28,121,149,91,32,6,107,68,656
438,Robert Gray Jr.,SR,2017-18,G,Houston,AAC,34,1084,218,488,157,318,61,170,158,197,23,102,125,148,38,4,79,53,655
439,Zeke Upshaw,SR,2013-14,G,Hofstra,CAA,33,1206,197,489,106,228,91,261,170,225,33,104,137,61,25,7,94,70,655
440,Jameel Warney,SR,2015-16,F,Stony Brook,AEC,33,1086,272,432,272,432,0,0,111,178,148,209,357,52,31,98,44,71,655
441,C.J. Burks,SR,2018-19,G,Marshall,CUSA,37,1240,247,517,181,332,66,185,94,122,22,122,144,109,66,6,111,85,654
442,Da'Sean Butler,SR,2009-10,F,West Virginia,Big East,38,1360,208,503,138,305,70,198,168,213,61,176,237,119,37,15,68,82,654
443,Marcus Foster,SR,2017-18,G,Creighton,Big East,33,1044,246,509,151,279,95,230,67,90,22,107,129,89,34,4,71,56,654
444,Alex Hamilton,SR,2015-16,G,Louisiana Tech,CUSA,33,1166,212,427,178,313,34,114,196,277,34,155,189,205,65,16,104,54,654
445,Jeremy Hazell,JR,2009-10,G,Seton Hall,Big East,32,1014,220,520,122,230,98,290,116,153,36,75,111,47,47,5,39,54,654
446,John Holland,SR,2010-11,F,Boston University,AEC,34,1153,203,526,127,296,76,230,172,200,44,152,196,54,47,11,73,79,654
447,Caleb Martin,SR,2018-19,F,Nevada,MWC,34,1161,201,492,94,175,107,317,145,198,30,145,175,96,49,26,63,83,654
448,Marcus Morris,JR,2010-11,F,Kansas,Big 12,38,1076,240,421,214,345,26,76,148,215,99,191,290,62,32,24,67,97,654
449,Luke Harangody,SR,2009-10,F,Notre Dame,Big East,30,989,244,507,219,426,25,81,140,178,67,206,273,47,14,20,54,70,653
450,Tim Kempton,SR,2016-17,C,Lehigh,Patriot,32,1012,231,422,208,366,23,56,168,221,62,271,333,36,29,41,99,99,653
451,Wendell McKines,SR,2011-12,F,New Mexico State,WAC,35,1179,233,505,182,360,51,145,136,179,118,256,374,54,27,13,70,80,653
454,Isaiah Miles,SR,2015-16,F,Saint Joseph's,A-10,36,1239,223,426,158,257,65,169,142,160,84,208,292,31,21,36,41,102,653
455,Sean Singletary,SR,2007-08,G,Virginia,ACC,33,1122,203,476,145,318,58,158,189,222,26,101,127,202,60,1,128,88,653
456,Greg Sprink,SR,2007-08,G,Navy,Patriot,30,1036,189,523,113,269,76,254,199,232,44,146,190,86,39,5,103,105,653
457,Alex Young,SR,2011-12,G,IUPUI,Summit,32,1050,219,516,160,342,59,174,156,191,59,130,189,69,50,32,78,80,653
458,Michael Deloach,SR,2009-10,G,Norfolk State,MEAC,30,1077,238,474,202,359,36,115,140,208,27,106,133,100,79,3,123,92,652
459,Nick Fazekas,SR,2006-07,F,Nevada,WAC,32,969,248,437,220,372,28,65,128,151,95,259,354,56,24,48,64,74,652
460,Terell Gomez,SO,2018-19,G,Cal State Northridge,Big West,34,1282,214,476,97,197,117,279,107,122,12,58,70,96,36,0,60,45,652
461,Troy Huff,SR,2013-14,G,North Dakota,Big Sky,34,993,210,467,168,328,42,139,190,250,96,135,231,41,79,10,64,57,652
462,Garrison Mathews,SO,2016-17,G,Lipscomb,A-Sun,32,1002,202,441,113,188,89,253,159,219,39,140,179,73,27,6,74,83,652
463,Donald Sims,SR,2010-11,G,Appalachian State,Southern,31,1174,198,447,120,227,78,220,178,206,11,105,116,112,53,5,86,47,652
464,Ben Smith,SR,2009-10,G,Jacksonville,A-Sun,33,1237,187,458,106,232,81,226,197,253,23,82,105,120,66,4,66,57,652
465,Reed Timmer,SR,2017-18,G,Drake,MVC,34,1134,188,422,95,197,93,225,183,212,18,103,121,79,21,3,65,57,652
466,Shizz Alston Jr.,SR,2018-19,G,Temple,AAC,33,1214,207,511,108,228,99,283,138,152,17,74,91,166,49,5,84,63,651
467,Ge'Lawn Guyn,SR,2015-16,G,East Tennessee State,Southern,35,1141,221,510,127,287,94,223,115,153,21,120,141,65,39,27,68,74,651
468,Nathan Knight,JR,2018-19,F,William & Mary,CAA,31,949,236,408,226,367,10,41,169,231,83,183,266,110,13,70,84,93,651
469,Elton Nesbitt,SR,2005-06,G,Georgia Southern,Southern,30,960,211,498,108,234,103,264,126,157,22,83,105,89,60,3,69,82,651
470,Jerome Randle,SR,2009-10,G,University of California,Pac-10,35,1224,210,460,118,232,92,228,139,149,14,59,73,150,26,0,123,52,651
471,Loren Stokes,SR,2006-07,G,Hofstra,CAA,32,1250,230,484,203,406,27,78,164,242,38,142,180,98,37,10,85,65,651
472,Jermaine Marrow,SO,2017-18,G,Hampton,MEAC,34,1175,228,573,187,434,41,139,153,192,31,139,170,184,43,1,117,88,650
473,Martaveous McKnight,JR,2017-18,G,Arkansas-Pine Bluff,SWAC,35,1134,217,480,153,298,64,182,152,210,16,134,150,124,68,5,92,31,650
476,Shamorie Ponds,JR,2018-19,G,St. John's (NY),Big East,33,1159,216,477,151,293,65,184,153,183,32,104,136,169,87,9,65,66,650
477,Demetric Bennett,SR,2007-08,G,South Alabama,Sun Belt,33,1147,213,443,123,221,90,222,133,159,44,148,192,84,42,2,81,41,649
478,Kyle Vinales,SO,2012-13,G,Central Connecticut State,NEC,30,1147,229,557,149,338,80,219,111,138,8,53,61,113,42,4,100,60,649
479,Chris Warren,SR,2010-11,G,Mississippi,SEC,34,1185,193,479,98,200,95,279,168,181,7,69,76,128,23,3,72,61,649
480,Alex Young,JR,2010-11,G,IUPUI,Summit,33,1208,244,513,204,393,40,120,121,165,69,142,211,78,45,26,113,88,649
481,Harrison Barnes,SO,2011-12,F,North Carolina,ACC,38,1111,229,521,180,384,49,137,141,195,74,124,198,43,41,13,74,68,648
482,T.J. Cline,SR,2016-17,F,Richmond,A-10,35,1137,243,470,195,318,48,152,114,166,30,242,272,197,33,8,103,88,648
483,Randy Culpepper,SO,2008-09,G,Texas-El Paso,CUSA,37,1119,211,515,122,258,89,257,137,184,30,79,109,67,67,11,84,104,648
484,K.T. Harrell,SR,2014-15,G,Auburn,SEC,35,1156,194,428,96,202,98,226,162,199,32,72,104,52,33,2,86,80,648
485,Paul Millsap,JR,2005-06,F,Louisiana Tech,WAC,33,1126,258,452,253,438,5,14,127,204,197,241,438,36,62,76,83,101,648
486,Andrew Rowsey,FR,2013-14,G,North Carolina-Asheville,Big South,32,1156,202,471,96,209,106,262,138,165,14,104,118,94,42,3,102,63,648
487,Jeff Short,JR,2014-15,G,Norfolk State,MEAC,34,1153,212,426,143,251,69,175,155,189,24,118,142,66,32,14,96,63,648
488,Ike Smith,SO,2016-17,G,Georgia Southern,Sun Belt,33,1005,230,462,169,308,61,154,127,195,35,137,172,56,47,21,72,74,648
489,A.D. Vassallo,SR,2008-09,G,Virginia Tech,ACC,34,1247,232,516,149,290,83,226,101,121,47,164,211,88,28,29,85,74,648
490,DaShaun Wood,SR,2006-07,G,Wright State,Horizon,33,1195,223,513,164,355,59,158,143,162,35,132,167,131,64,6,84,59,648
491,Michael Young,SR,2016-17,F,Pittsburgh,ACC,33,1097,217,479,175,356,42,123,172,221,53,170,223,90,19,25,70,59,648
492,Josh Akognon,JR,2007-08,G,Cal State Fullerton,Big West,32,1013,212,472,96,177,116,295,107,119,18,89,107,48,44,4,55,71,647
493,Mario Boggan,SR,2006-07,F,Oklahoma State,Big 12,34,1109,242,448,229,389,13,59,150,197,88,169,257,47,36,27,86,100,647
494,Jahii Carson,FR,2012-13,G,Arizona State,Pac-12,35,1303,231,488,198,385,33,103,152,207,16,112,128,177,41,2,124,89,647
495,Jordan Downing,JR,2013-14,G,Presbyterian,Big South,32,1191,235,541,155,323,80,218,97,119,21,123,144,60,32,12,72,67,647
498,Wayne Ellington,SO,2007-08,G,North Carolina,ACC,39,1214,237,507,159,312,78,195,95,115,41,133,174,78,44,7,66,62,647
499,Michael Gbinije,SR,2015-16,F,Syracuse,ACC,37,1403,225,488,134,255,91,233,106,160,40,111,151,159,70,13,105,98,647
500,Shamorie Ponds,SO,2017-18,G,St. John's (NY),Big East,30,1110,225,536,178,350,47,186,150,175,36,115,151,142,70,3,82,53,647
501,Jared Sullinger,SO,2011-12,F,Ohio State,Big Ten,37,1123,228,439,212,399,16,40,175,228,116,224,340,46,43,39,71,109,647
502,Tyshawn Taylor,SR,2011-12,G,Kansas,Big 12,39,1303,226,474,168,322,58,152,137,199,8,83,91,186,52,6,138,77,647
503,Greivis Vasquez,SR,2009-10,G,Maryland,ACC,33,1120,220,513,151,321,69,192,138,161,38,115,153,208,56,12,111,69,647
504,Nick Young,JR,2006-07,F,Southern California,Pac-10,37,1227,239,455,195,355,44,100,125,159,44,127,171,50,27,10,90,92,647
505,Antoine Agudio,JR,2006-07,G,Hofstra,CAA,32,1256,219,476,119,245,100,231,108,156,34,95,129,78,36,4,73,58,646
506,David Holston,JR,2007-08,G,Chicago State,Ind,28,932,202,470,72,148,130,322,112,132,25,61,86,142,58,2,109,61,646
507,Caleb Swanigan,SO,2016-17,F,Purdue,Big Ten,35,1139,222,421,184,336,38,85,164,210,96,340,436,107,15,28,118,97,646
508,Jermaine Taylor,JR,2007-08,G,Central Florida,CUSA,31,1037,231,501,152,286,79,215,105,132,53,94,147,52,35,9,78,66,646
509,Ed Tyson,JR,2007-08,G,Maryland-Eastern Shore,MEAC,32,1176,219,585,146,359,73,226,135,177,57,49,106,46,54,1,102,92,646
510,Keaton Wallace,SO,2018-19,G,Texas-San Antonio,CUSA,32,1117,215,509,94,192,121,317,95,111,25,136,161,76,42,22,69,72,646
511,Craig Brackins,SO,2008-09,F,Iowa State,Big 12,32,1041,243,512,222,438,21,74,138,198,55,248,303,43,17,30,74,67,645
512,Jared Cunningham,JR,2011-12,G,Oregon State,Pac-12,36,1245,198,440,148,292,50,148,199,270,36,102,138,101,91,15,102,86,645
513,Chris Lofton,JR,2006-07,G,Tennessee,SEC,31,917,205,428,99,175,106,253,129,159,34,61,95,54,45,4,51,49,645
514,Andrew Nicholson,JR,2010-11,F,St. Bonaventure,A-10,31,1049,237,415,231,392,6,23,165,232,52,173,225,32,17,45,99,92,645
515,Jerome Hill,JR,2014-15,F,Gardner-Webb,Big South,34,1126,211,446,205,408,6,38,216,344,118,227,345,75,18,23,101,76,644
516,Gerald Brown,JR,2006-07,G,Loyola (MD),MAAC,29,1018,205,465,147,296,58,169,175,234,37,107,144,78,54,13,119,100,643
517,Deonte Burton,SR,2013-14,G,Nevada,MWC,32,1236,215,456,166,300,49,156,164,221,12,125,137,142,48,17,65,71,643
520,Cameron Jones,SR,2010-11,G,Northern Arizona,Big Sky,32,1077,250,547,213,456,37,91,106,133,31,116,147,101,28,3,72,63,643
521,Carl Landry,JR,2006-07,F,Purdue,Big Ten,34,1035,219,367,215,348,4,19,201,277,101,148,249,42,40,32,102,99,643
522,Joe Young,JR,2013-14,G,Oregon,Pac-12,34,1059,206,429,130,246,76,183,155,176,26,70,96,66,44,1,39,47,643
523,Jerrick Harding,JR,2018-19,G,Weber State,Big Sky,30,1016,212,450,148,275,64,175,154,177,15,86,101,42,50,11,62,67,642
524,Quinton Hooker,JR,2015-16,G,North Dakota,Big Sky,32,1136,211,433,160,300,51,133,169,197,37,119,156,112,60,8,58,72,642
525,John Konchar,SR,2018-19,G,Purdue-Fort Wayne,Summit,33,1131,231,423,178,284,53,139,127,178,73,209,282,179,65,31,91,69,642
526,Shawn Long,SR,2015-16,F,Louisiana,Sun Belt,34,1042,232,443,214,376,18,67,160,235,137,274,411,47,24,61,91,95,642
527,Damon Lynn,JR,2015-16,G,NJIT,A-Sun,35,1323,196,524,80,174,116,350,134,161,11,95,106,114,56,2,71,44,642
528,T.J. Williams,SR,2016-17,G,Northeastern,CAA,30,1145,202,436,166,328,36,108,202,265,23,118,141,158,31,4,101,67,642
529,Perry Ellis,SR,2015-16,F,Kansas,Big 12,38,1150,237,446,209,382,28,64,139,177,67,155,222,49,18,19,56,64,641
530,Wesley Matthews,SR,2008-09,G,Marquette,Big East,35,1191,193,406,151,292,42,114,213,257,46,155,201,86,43,18,82,76,641
531,Jalan West,JR,2014-15,G,Northwestern State,Southland,32,1104,193,423,107,219,86,204,169,196,18,122,140,246,66,11,90,63,641
532,Jarrell Brantley,SR,2018-19,F,College of Charleston,CAA,33,1121,237,458,199,342,38,116,128,163,57,220,277,80,46,29,85,89,640
533,Jared Brownridge,JR,2015-16,G,Santa Clara,WCC,31,1110,195,491,104,255,91,236,159,191,11,87,98,72,22,6,58,67,640
534,Jevon Carter,SR,2017-18,G,West Virginia,Big 12,37,1313,215,509,138,313,77,196,133,155,29,143,172,246,112,13,98,111,640
535,Tyler Cavanaugh,SR,2016-17,F,George Washington,A-10,35,1126,200,446,133,282,67,164,173,204,87,207,294,71,19,14,93,98,640
536,J.J. Frazier,SR,2016-17,G,Georgia,SEC,34,1178,199,490,144,309,55,181,187,211,12,117,129,140,63,4,80,81,640
537,Justin Hurtt,SR,2010-11,G,Tulsa,CUSA,32,1079,206,494,120,260,86,234,142,175,16,105,121,76,16,7,88,53,640
538,Nigel Williams-Goss,JR,2016-17,G,Gonzaga,WCC,38,1248,220,453,177,336,43,117,157,181,22,205,227,179,64,3,81,60,640
539,Bonzie Colson,JR,2016-17,F,Notre Dame,ACC,36,1156,236,449,210,389,26,60,141,180,104,258,362,56,40,50,44,81,639
540,Papa Dia,SR,2010-11,F,Southern Methodist,CUSA,35,1177,243,421,230,391,13,30,140,186,104,231,335,63,23,77,125,109,639
541,Darryl Proctor,SR,2008-09,F,Maryland-Baltimore County,AEC,32,1269,254,544,252,530,2,14,129,182,83,197,280,63,44,21,70,82,639
542,Clifford Reed,JR,2010-11,G,Bethune-Cookman,MEAC,34,1315,203,522,149,357,54,165,179,219,27,103,130,163,55,1,102,87,639
543,D.J. Rivera,JR,2008-09,F,Binghamton,AEC,32,1134,230,486,183,337,47,149,132,208,65,143,208,34,57,13,56,86,639
544,James Anderson,SO,2008-09,G,Oklahoma State,Big 12,35,1171,209,434,125,228,84,206,136,164,76,122,198,48,40,24,69,85,638
545,Tyler Cavanaugh,JR,2015-16,F,George Washington,A-10,38,1157,209,414,156,287,53,127,167,202,76,213,289,46,21,10,79,95,638
546,David Efianayi,SR,2018-19,G,Gardner-Webb,Big South,35,1169,201,413,130,244,71,169,165,222,18,110,128,100,39,26,84,74,638
547,Marcus Foster,JR,2016-17,G,Creighton,Big East,35,1081,245,532,172,318,73,214,75,107,9,92,101,84,21,2,78,69,638
548,Robert Gray Jr.,JR,2016-17,G,Houston,AAC,31,1002,233,493,170,328,63,165,109,134,33,83,116,91,37,5,70,57,638
549,Max Landis,SR,2015-16,G,Purdue-Fort Wayne,Summit,33,1228,196,433,71,159,125,274,121,149,5,65,70,121,30,1,72,44,638
550,Kyle Wiltjer,JR,2014-15,F,Gonzaga,WCC,38,1049,242,448,174,302,68,146,86,109,51,184,235,71,18,25,43,62,638
551,Bryce Brown,SR,2018-19,G,Auburn,SEC,40,1281,204,467,63,123,141,344,88,109,18,65,83,77,44,2,66,56,637
552,Glenn Cosey,SR,2013-14,G,Eastern Kentucky,OVC,34,1234,187,435,72,165,115,270,148,176,20,89,109,142,42,2,63,59,637
553,Brandon Davies,SR,2012-13,F,Brigham Young,WCC,36,1054,229,439,224,425,5,14,174,255,74,213,287,88,48,35,92,111,637
554,Malcolm Delaney,SR,2010-11,G,Virginia Tech,ACC,34,1300,186,443,102,237,84,206,181,213,27,92,119,137,56,6,103,89,637
555,Jakeenan Gant,SR,2018-19,F,Louisiana,Sun Belt,31,1003,246,453,204,341,42,112,103,131,98,171,269,39,25,82,64,85,637
556,Adam Haluska,SR,2006-07,G,Iowa,Big Ten,31,1070,190,466,100,218,90,248,167,192,27,117,144,80,42,8,53,54,637
557,Brandon Heath,SR,2006-07,G,San Diego State,MWC,33,1218,225,534,138,287,87,247,100,134,29,98,127,120,64,2,104,54,637
558,Egor Koulechov,JR,2016-17,G,Rice,CUSA,35,1201,208,440,127,269,81,171,140,171,65,247,312,75,29,11,71,70,637
559,Matt Mooney,JR,2017-18,G,South Dakota,Summit,34,1040,227,510,151,294,76,216,107,129,22,116,138,105,67,4,82,67,637
562,Mike Moore,SR,2011-12,G,Hofstra,CAA,32,1108,200,477,119,270,81,207,156,191,23,123,146,66,55,2,94,71,637
563,Mike Muscala,SR,2012-13,F,Bucknell,Patriot,34,1079,227,446,223,430,4,16,179,227,98,280,378,78,17,80,58,74,637
564,Kevin Pittsnogle,SR,2005-06,C,West Virginia,Big East,33,1187,231,485,140,258,91,227,84,98,53,128,181,40,31,39,46,57,637
565,Marial Shayok,SR,2018-19,G,Iowa State,Big 12,34,1118,229,462,158,278,71,184,108,123,47,120,167,67,32,8,91,70,637
566,Lamar Stevens,JR,2018-19,F,Penn State,Big Ten,32,1180,230,545,210,454,20,91,157,204,53,192,245,66,22,26,89,83,637
567,J.P. Batista,SR,2005-06,C,Gonzaga,WCC,33,1077,234,397,231,389,3,8,165,198,98,212,310,46,30,28,80,82,636
568,Elijah Bryant,JR,2017-18,G,Brigham Young,WCC,35,1215,202,409,117,204,85,205,147,173,16,206,222,81,44,19,80,83,636
569,Rodney Carney,SR,2005-06,F,Memphis,CUSA,37,1027,220,505,118,244,102,261,94,132,57,101,158,47,49,25,54,84,636
570,Patrick Cole,SR,2016-17,G,North Carolina Central,MEAC,33,1166,203,529,137,335,66,194,164,217,39,191,230,184,31,8,124,79,636
571,Peter Jok,SR,2016-17,G,Iowa,Big Ten,32,983,199,467,115,246,84,221,154,169,30,146,176,84,34,3,81,70,636
572,Dior Lowhorn,SO,2007-08,F,San Francisco,WCC,31,1135,252,491,243,456,9,35,123,174,89,140,229,22,14,28,93,51,636
573,C.J. Massinburg,SR,2018-19,G,Buffalo,MAC,35,1123,199,429,106,196,93,233,145,186,76,152,228,104,42,10,47,61,636
574,Yante Maten,SR,2017-18,F,Georgia,SEC,33,1131,207,446,178,361,29,85,193,241,116,167,283,51,15,49,67,72,636
575,Talor Battle,SO,2008-09,G,Penn State,Big Ten,38,1422,198,493,106,222,92,271,147,210,36,167,203,189,45,3,92,79,635
576,Dillon Brooks,SO,2015-16,F,Oregon,Pac-12,38,1247,231,492,183,350,48,142,125,155,77,129,206,119,40,15,89,112,635
577,Frank Gaines,JR,2011-12,G,Purdue-Fort Wayne,Summit,30,962,207,465,158,323,49,142,172,230,39,137,176,36,41,18,77,90,635
578,Curtis Jerrells,SR,2008-09,G,Baylor,Big 12,39,1351,197,461,121,254,76,207,165,214,32,145,177,192,60,12,119,76,635
579,Christian Keeling,JR,2018-19,G,Charleston Southern,Big South,34,1096,214,460,133,247,81,213,126,162,29,206,235,94,43,23,91,68,635
580,Zane Martin,SO,2017-18,G,Towson,CAA,32,966,226,493,155,306,71,187,112,161,18,95,113,85,25,6,76,66,635
581,Drew McDonald,SR,2018-19,F,Northern Kentucky,Horizon,34,1040,211,447,144,277,67,170,146,183,68,251,319,95,17,12,77,65,635
584,Drew Neitzel,JR,2006-07,G,Michigan State,Big Ten,35,1249,199,467,85,190,114,277,123,140,3,96,99,151,29,9,82,42,635
585,Jared Sullinger,FR,2010-11,F,Ohio State,Big Ten,37,1172,222,410,219,398,3,12,188,267,131,246,377,43,37,20,59,90,635
586,Francis Alonso,SR,2018-19,G,North Carolina-Greensboro,Southern,36,1033,195,465,97,201,98,264,146,166,18,66,84,89,37,6,92,78,634
587,Gary Blackston,JR,2017-18,G,Prairie View,SWAC,33,1064,217,494,173,371,44,123,156,217,48,128,176,116,51,3,100,110,634
588,Leemire Goldwire,SR,2007-08,G,Charlotte,A-10,34,1130,194,520,66,149,128,371,118,146,37,111,148,58,70,3,83,91,634
589,Rob McKiver,JR,2006-07,G,Houston,CUSA,33,1236,201,532,85,189,116,343,116,160,9,97,106,112,44,1,99,69,634
590,Matt Mooney,SO,2016-17,G,South Dakota,Summit,34,1059,222,483,146,276,76,207,114,159,14,138,152,71,75,5,86,65,634
591,Nick Barbour,SR,2011-12,G,High Point,Big South,31,1014,185,415,77,192,108,223,155,187,16,62,78,42,34,11,53,65,633
592,Anatoly Bose,JR,2009-10,G,Nicholls State,Southland,30,1062,194,442,108,218,86,224,159,214,43,136,179,61,34,8,83,62,633
593,John Cantrell,SR,2008-09,G,Chicago State,Ind,32,1120,245,483,214,396,31,87,112,158,65,97,162,69,72,10,62,63,633
594,Keenan Evans,SR,2017-18,G,Texas Tech,Big 12,36,1063,194,412,146,262,48,150,197,241,12,98,110,116,41,11,70,65,633
595,Stephen McDowell,SR,2008-09,G,Chattanooga,Southern,35,1177,202,464,67,146,135,318,94,118,33,84,117,54,32,0,61,57,633
596,Domantas Sabonis,SO,2015-16,F,Gonzaga,WCC,36,1149,239,391,234,377,5,14,150,195,110,316,426,64,22,31,92,115,633
597,Craig Smith,SR,2005-06,F,Boston College,ACC,36,1305,243,424,242,412,1,12,146,227,112,227,339,109,44,29,89,107,633
598,Xavier Thames,SR,2013-14,G,San Diego State,MWC,36,1126,188,457,127,294,61,163,196,235,21,83,104,116,59,5,51,71,633
599,John Collins,SO,2016-17,F,Wake Forest,ACC,33,878,234,376,234,375,0,1,164,220,124,200,324,17,21,52,60,98,632
600,A.J. English,SR,2015-16,G,Iona,MAAC,28,1005,190,439,96,185,94,254,158,189,15,126,141,174,44,14,101,60,632
601,Tyreke Evans,FR,2008-09,G,Memphis,CUSA,37,1072,230,505,196,381,34,124,138,194,47,151,198,143,77,29,133,89,632
602,Frank Gaines,SR,2012-13,G,Purdue-Fort Wayne,Summit,32,1089,198,457,143,297,55,160,181,245,34,95,129,38,44,16,79,82,632
603,Brandon Goodwin,SR,2017-18,G,Florida Gulf Coast,A-Sun,34,1135,223,474,181,321,42,153,144,192,38,150,188,162,46,4,100,53,632
606,Chris Harris,SR,2009-10,G,Navy,Patriot,30,1047,183,512,95,255,88,257,178,204,8,67,75,56,60,3,88,85,632
607,Collin Sexton,FR,2017-18,G,Alabama,SEC,33,987,196,438,152,307,44,131,196,252,34,90,124,119,28,3,92,81,632
608,Ben Simmons,FR,2015-16,F,Louisiana State,SEC,33,1151,216,386,215,383,1,3,199,297,103,285,388,158,65,27,111,92,632
609,Evan Turner,JR,2009-10,G,Ohio State,Big Ten,31,1108,237,457,217,402,20,55,138,183,62,222,284,185,54,28,136,86,632
610,Sherrod Wright,JR,2012-13,G,George Mason,CAA,38,1228,202,434,155,300,47,134,181,233,66,120,186,56,38,10,99,73,632
611,Will Barton,SO,2011-12,G,Memphis,CUSA,35,1236,230,452,193,345,37,107,134,179,70,209,279,102,50,25,75,74,631
612,Larry Blair,SR,2006-07,G,Liberty,Big South,31,1023,237,538,185,366,52,172,105,124,26,104,130,102,58,6,84,69,631
613,David Brown,SR,2013-14,G,Western Michigan,MAC,33,1123,176,428,96,181,80,247,199,258,19,98,117,61,47,5,92,93,631
614,Eugene German,JR,2018-19,G,Northern Illinois,MAC,31,1012,228,465,141,255,87,210,88,128,17,143,160,89,38,5,74,61,631
615,Tu Holloway,JR,2010-11,G,Xavier,A-10,32,1228,168,396,108,222,60,174,235,270,18,141,159,174,46,2,110,61,631
616,Shawn Long,SO,2013-14,F,Louisiana,Sun Belt,34,999,239,458,206,380,33,78,120,178,121,232,353,19,23,91,73,119,631
617,C.J. McCollum,FR,2009-10,G,Lehigh,Patriot,33,1052,203,442,131,271,72,171,153,189,46,119,165,79,43,7,66,48,631
618,Kevin Palmer,SR,2009-10,G,Texas A&M-Corpus Christi,Southland,32,1053,203,438,152,279,51,159,174,229,55,119,174,88,77,9,139,69,631
619,Chase Budinger,JR,2008-09,F,Arizona,Pac-10,35,1317,219,456,152,288,67,168,125,156,49,168,217,118,50,16,85,65,630
620,Bryce Cotton,JR,2012-13,G,Providence,Big East,32,1209,195,446,97,177,98,269,142,178,23,92,115,92,30,3,47,38,630
621,Jon Davis,SR,2018-19,G,Charlotte,CUSA,29,1076,191,441,118,225,73,216,175,205,11,119,130,107,24,12,121,43,630
622,Matt Morgan,JR,2017-18,G,Cornell,Ivy,28,969,204,415,129,212,75,203,147,180,11,118,129,90,23,9,69,48,630
623,Nik Stauskas,SO,2013-14,G,Michigan,Big Ten,36,1281,185,394,93,186,92,208,168,204,15,90,105,118,20,11,67,47,630
624,DeMarre Carroll,SR,2008-09,F,Missouri,Big 12,38,1064,246,441,230,397,16,44,121,191,92,181,273,82,59,25,56,84,629
625,Brandon Goodwin,JR,2016-17,G,Florida Gulf Coast,A-Sun,34,1073,219,428,164,272,55,156,136,172,28,126,154,139,41,2,72,73,629
628,Demontrae Jefferson,SO,2017-18,G,Texas Southern,SWAC,27,1016,207,493,122,277,85,216,130,158,18,66,84,123,36,0,85,68,629
629,"David Jenkins, Jr.",SO,2018-19,G,South Dakota State,Summit,32,1059,205,448,93,201,112,247,107,135,14,94,108,49,15,0,84,88,629
630,Charles Jenkins,SO,2008-09,G,Hofstra,CAA,32,1122,203,503,172,404,31,99,192,234,28,125,153,137,46,15,107,84,629
631,Marcelus Kemp,JR,2006-07,G,Nevada,WAC,34,1058,221,478,137,271,84,207,103,128,36,121,157,82,24,7,98,74,629
632,Roddy Peters,SR,2017-18,G,Nicholls State,Southland,32,858,229,445,218,407,11,38,160,210,28,160,188,135,44,6,121,79,629
633,Bobby Portis,SO,2014-15,F,Arkansas,SEC,36,1076,250,466,236,436,14,30,115,156,133,188,321,42,39,50,56,78,629
634,Tyrese Rice,JR,2007-08,G,Boston College,ACC,30,1144,200,462,136,283,64,179,165,195,12,86,98,149,48,6,103,67,629
635,Jordan Washington,SR,2016-17,F,Iona,MAAC,35,760,233,422,232,418,1,4,162,236,83,182,265,22,32,14,78,122,629
636,Quinndary Weatherspoon,SR,2018-19,G,Mississippi State,SEC,34,1157,213,419,158,280,55,139,148,183,45,114,159,96,57,10,99,72,629
637,Jaylen Barford,SR,2017-18,G,Arkansas,SEC,35,1094,224,477,137,276,87,201,93,129,35,102,137,89,35,10,67,88,628
638,Keith Benson,SR,2010-11,C,Oakland,Summit,35,1133,231,422,222,399,9,23,157,244,93,261,354,38,28,125,66,108,628
639,Corey Davis Jr.,SR,2018-19,G,Houston,AAC,37,1222,202,481,91,185,111,296,113,130,26,97,123,103,38,3,54,65,628
640,Jerian Grant,SR,2014-15,G,Notre Dame,ACC,38,1408,204,427,154,269,50,158,170,218,13,102,115,253,63,19,82,75,628
641,Preston Medlin,SO,2011-12,G,Utah State,WAC,37,1302,204,411,109,189,95,222,125,156,5,159,164,124,26,5,73,55,628
642,Darryl Partin,SR,2011-12,G,Boston University,AEC,32,1078,218,536,149,315,69,221,123,171,37,88,125,35,35,3,101,55,628
643,Andrew White III,SR,2016-17,G,Syracuse,ACC,34,1266,199,451,87,173,112,278,118,141,28,130,158,38,55,12,56,72,628
644,Jonathan Williams,SR,2016-17,G,Toledo,MAC,32,1097,212,479,146,272,66,207,138,169,22,75,97,102,25,4,87,67,628
645,Nisre Zouzoua,SO,2016-17,G,Bryant,NEC,31,1102,208,508,116,257,92,251,120,156,29,100,129,48,45,13,59,83,628
646,DeAndre Bembry,JR,2015-16,F,Saint Joseph's,A-10,36,1341,238,497,204,369,34,128,117,178,51,228,279,161,51,30,73,88,627
647,Brandon Clarke,JR,2018-19,F,Gonzaga,WCC,37,1040,257,374,253,359,4,15,109,157,114,203,317,70,43,117,57,79,627
648,Alex Harris,SR,2007-08,G,UC-Santa Barbara,Big West,31,1005,186,433,112,258,74,175,181,223,31,84,115,53,35,5,81,67,627
649,DeSean Murray,SO,2015-16,F,Presbyterian,Big South,31,902,232,427,232,420,0,7,163,211,74,154,228,53,62,17,95,94,627
650,Brian Roberts,SR,2007-08,G,Dayton,A-10,34,1179,208,437,108,217,100,220,111,129,8,88,96,117,12,4,94,60,627
651,Jeremy Senglin,JR,2015-16,G,Weber State,Big Sky,35,1220,213,437,107,192,106,245,95,154,12,110,122,97,23,3,77,62,627
652,Chaz Williams,SO,2011-12,G,Massachusetts,A-10,37,1291,195,476,133,328,62,148,175,222,36,125,161,231,81,7,126,104,627
653,Jordan Adams,SO,2013-14,G,UCLA,Pac-12,36,1082,208,429,156,283,52,146,158,189,67,125,192,84,95,5,54,78,626
654,George Beamon,JR,2011-12,G,Manhattan,MAAC,33,1055,210,432,149,289,61,143,145,181,53,132,185,65,48,15,89,70,626
655,Isaiah Canaan,JR,2011-12,G,Murray State,OVC,33,1112,187,400,89,185,98,215,154,184,27,87,114,120,45,2,89,56,626
656,Shane Gibson,SR,2012-13,G,Sacred Heart,NEC,29,951,212,475,125,266,87,209,115,132,23,100,123,41,33,9,95,76,626
657,Melvin Johnson,SR,2015-16,G,Virginia Commonwealth,A-10,36,1134,223,535,113,246,110,289,70,86,21,75,96,78,45,2,54,47,626
658,Jacob Pullen,SR,2010-11,G,Kansas State,Big 12,31,1012,191,448,117,254,74,194,170,220,20,70,90,115,49,4,95,55,626
659,Jonathan Rodriguez,SO,2007-08,F,Campbell,A-Sun,30,1051,202,414,188,363,14,51,208,272,93,211,304,75,47,17,109,73,626
660,Mike Smith,SR,2010-11,F,East Tennessee State,A-Sun,35,1194,222,473,175,345,47,128,135,171,60,179,239,66,29,15,81,114,626
661,Ethan Telfair,JR,2015-16,G,Idaho State,Big Sky,31,1108,179,450,116,287,63,163,205,236,27,96,123,167,74,4,112,78,626
662,Olivier Hanlan,JR,2014-15,G,Boston College,ACC,32,1204,225,496,160,312,65,184,110,145,24,111,135,135,41,1,85,68,625
663,Ben Hansbrough,SR,2010-11,G,Notre Dame,Big East,34,1202,194,405,107,205,87,200,150,184,25,106,131,145,41,4,81,88,625
664,Luke Maye,JR,2017-18,F,North Carolina,ACC,37,1193,251,516,201,400,50,116,73,117,113,260,373,88,36,38,69,92,625
665,David Nichols,SO,2016-17,G,Albany (NY),AEC,35,1182,248,560,197,416,51,144,78,94,14,107,121,111,43,3,93,97,625
666,D'Marcus Simonds,JR,2018-19,G,Georgia State,Sun Belt,34,1214,219,530,162,328,57,202,130,197,25,144,169,123,43,33,125,80,625
667,Kyle Singler,SR,2010-11,F,Duke,ACC,37,1286,219,509,157,316,62,193,125,155,88,165,253,60,34,12,70,98,625
670,Justin Tillman,SR,2017-18,F,Virginia Commonwealth,A-10,33,1012,248,445,221,363,27,82,102,156,109,218,327,15,11,34,56,78,625
671,Lawrence Alexander,SR,2014-15,G,North Dakota State,Summit,33,1271,203,472,99,236,104,236,114,141,14,136,150,56,29,7,65,45,624
672,Kevin Anderson,JR,2009-10,G,Richmond,A-10,35,1300,231,505,193,393,38,112,124,152,22,96,118,93,61,12,83,58,624
673,Martin Breunig,SR,2015-16,F,Montana,Big Sky,33,1005,228,367,225,357,3,10,165,233,97,201,298,48,22,37,73,110,624
674,Yoeli Childs,SO,2017-18,F,Brigham Young,WCC,35,1191,246,455,231,407,15,48,117,182,70,231,301,77,30,63,76,79,624
675,Brandon Ingram,FR,2015-16,G,Duke,ACC,36,1246,214,484,134,289,80,195,116,170,67,177,244,72,41,49,72,74,624
676,John Jenkins,SO,2010-11,G,Vanderbilt,SEC,32,1105,190,411,90,166,100,245,144,161,17,78,95,39,24,11,52,44,624
677,Denzel Livingston,SR,2014-15,G,Incarnate Word,Southland,29,1071,190,418,144,284,46,134,198,246,43,129,172,85,74,38,80,86,624
678,Jason Thompson,JR,2006-07,C,Rider,MAAC,31,1057,221,425,215,403,6,22,176,243,92,220,312,65,23,67,93,102,624
679,Tres Tinkle,JR,2018-19,F,Oregon State,Pac-12,30,1094,215,445,162,284,53,161,141,183,60,183,243,115,52,16,89,63,624
680,Jarrod Uthoff,SR,2015-16,F,Iowa,Big Ten,33,1016,218,487,152,314,66,173,122,150,48,161,209,36,32,86,38,51,624
681,Kyle Allman,JR,2017-18,G,Cal State Fullerton,Big West,32,1053,198,405,153,300,45,105,182,244,11,100,111,75,36,6,74,68,623
682,LaVell Boyd,SR,2016-17,G,Missouri-Kansas City,WAC,35,1086,189,461,102,245,87,216,158,190,19,123,142,136,37,1,89,95,623
683,Joe Chealey,JR,2016-17,G,College of Charleston,CAA,35,1184,175,405,110,239,65,166,208,253,16,107,123,113,35,1,60,82,623
684,Jordan Howard,JR,2016-17,G,Central Arkansas,Southland,32,1098,189,439,88,212,101,227,144,162,9,107,116,93,36,2,80,34,623
685,Darius Johnson-Odom,SR,2011-12,G,Marquette,Big East,34,1120,210,470,133,270,77,200,126,165,22,97,119,93,32,4,80,68,623
686,Carrington Love,SR,2015-16,G,Green Bay,Horizon,36,1174,204,485,119,240,85,245,130,218,20,78,98,129,94,10,61,68,623
687,Deishuan Booker,SR,2018-19,G,Long Beach State,Big West,33,1060,165,363,123,247,42,116,250,274,15,99,114,144,43,4,130,78,622
688,Obi Emegano,JR,2014-15,G,Oral Roberts,Summit,34,1168,194,434,165,359,29,75,205,260,26,134,160,76,57,6,87,70,622
689,Zeek Woodley,JR,2015-16,G,Northwestern State,Southland,28,925,216,407,159,267,57,140,133,150,47,98,145,44,27,16,55,67,622
692,Cameron Young,SR,2017-18,G,Quinnipiac,MAAC,33,1124,187,443,123,232,64,211,184,244,61,165,226,91,43,10,93,85,622
693,Aaron Brooks,SR,2006-07,G,Oregon,Pac-10,35,1289,213,463,133,265,80,198,115,136,31,118,149,149,48,6,89,88,621
694,Jordan Hill,JR,2008-09,F,Arizona,Pac-10,34,1213,252,469,252,469,0,0,117,179,143,232,375,50,30,58,97,102,621
695,Jon Leuer,SR,2010-11,F,Wisconsin,Big Ten,34,1139,227,483,173,337,54,146,113,134,57,189,246,56,17,30,54,75,621
696,Derrick Marks,SR,2014-15,G,Boise State,MWC,32,998,231,468,163,312,68,156,91,118,16,102,118,96,59,14,68,72,621
697,Jacorey Williams,SR,2016-17,F,Middle Tennessee,CUSA,36,1069,258,484,256,469,2,15,103,148,63,201,264,56,32,17,60,72,621
698,Tyler Zeller,SR,2011-12,F,North Carolina,ACC,38,1070,220,398,220,398,0,0,181,224,146,219,365,36,34,58,73,102,621
699,Aubrey Coleman,JR,2008-09,G,Houston,CUSA,32,1049,218,512,208,464,10,48,174,228,85,177,262,77,75,0,79,78,620
700,Jordan Davis,JR,2017-18,G,Northern Colorado,Big Sky,38,1103,236,458,220,391,16,67,132,207,40,143,183,121,36,15,118,104,620
701,Donte Greene,FR,2007-08,F,Syracuse,Big East,35,1253,218,521,128,260,90,261,94,133,60,191,251,71,45,57,91,101,620
702,Jakob Poeltl,SO,2015-16,F,Utah,Pac-12,36,1093,228,353,228,353,0,0,164,238,102,225,327,70,21,56,74,83,620
703,Jamar Wilson,SR,2006-07,G,Albany (NY),AEC,33,1199,209,460,163,343,46,117,156,209,52,153,205,159,40,12,119,70,620
704,Jaylen Adams,JR,2016-17,G,St. Bonaventure,A-10,30,1123,168,401,91,185,77,216,206,251,18,94,112,195,62,5,103,84,619
705,Khalil Ahmad,SR,2018-19,G,Cal State Fullerton,Big West,34,1069,207,475,151,299,56,176,149,183,19,116,135,43,55,6,69,85,619
706,Marcus Denmon,SR,2011-12,G,Missouri,Big 12,35,1212,200,435,101,192,99,243,120,134,35,141,176,74,54,1,41,34,619
707,Chandler Hutchison,SR,2017-18,G,Boise State,MWC,31,961,205,432,159,304,46,128,163,224,27,211,238,107,46,8,104,74,619
708,Mike Rose,SR,2008-09,G,Eastern Kentucky,OVC,31,1133,208,441,109,235,99,206,104,137,63,101,164,79,53,3,74,45,619
709,John Shurna,SO,2009-10,F,Northwestern,Big Ten,34,1238,217,473,139,253,78,220,107,138,58,158,216,88,28,32,67,74,619
710,Deshaun Thomas,SO,2011-12,F,Ohio State,Big Ten,39,1225,243,467,193,322,50,145,83,110,100,109,209,35,15,9,47,65,619
711,Justin Turner,SO,2018-19,G,Bowling Green State,MAC,34,1094,229,489,168,325,61,164,100,141,28,99,127,105,47,8,63,58,619
714,Arron Afflalo,SO,2005-06,G,UCLA,Pac-10,39,1303,203,439,120,212,83,227,129,160,32,132,164,69,24,5,79,83,618
715,Nathan Boothe,SR,2015-16,C,Toledo,MAC,32,1007,241,486,208,398,33,88,103,125,60,227,287,105,21,33,71,83,618
716,Anatoly Bose,SR,2010-11,G,Nicholls State,Southland,28,955,178,452,111,246,67,206,195,246,34,130,164,62,38,5,95,67,618
717,Nick Calathes,SO,2008-09,G,Florida,SEC,36,1200,205,425,132,238,73,187,135,191,31,161,192,231,68,6,119,69,618
718,Zac Cuthbertson,SR,2018-19,F,Coastal Carolina,Sun Belt,34,1091,200,410,156,290,44,120,174,228,75,202,277,80,32,15,80,103,618
719,Josh Hart,JR,2015-16,G,Villanova,Big East,40,1255,230,448,175,294,55,154,103,137,74,196,270,77,46,10,66,87,618
720,Reggie Jackson,JR,2010-11,G,Boston College,ACC,34,1161,219,435,148,266,71,169,109,137,35,111,146,152,36,18,81,58,618
721,Nick Johnson,JR,2013-14,G,Arizona,Pac-12,38,1257,205,474,143,305,62,169,146,187,31,123,154,107,43,25,64,76,618
722,Geoff Payne,JR,2007-08,F,Southern Utah,Summit,30,1070,219,386,219,382,0,4,180,261,81,123,204,70,54,13,91,80,618
723,Isaiah Whitehead,SO,2015-16,G,Seton Hall,Big East,34,1098,194,512,113,290,81,222,149,196,18,104,122,173,40,49,119,78,618
724,Anthony Beane,SR,2015-16,G,Southern Illinois,MVC,32,1097,208,481,136,287,72,194,129,168,22,101,123,57,36,0,86,88,617
725,Joel Berry,SR,2017-18,G,North Carolina,ACC,36,1193,208,525,115,255,93,270,108,121,20,107,127,116,42,12,68,58,617
726,John Brown,JR,2014-15,F,High Point,Big South,32,995,242,440,242,434,0,6,133,176,101,91,192,39,39,33,53,66,617
727,Zach Cooks,SO,2018-19,G,NJIT,A-Sun,35,1304,216,479,143,270,73,209,112,153,22,147,169,73,88,2,76,68,617
728,Josh Davis,JR,2012-13,F,Tulane,CUSA,35,1250,207,421,206,419,1,2,202,282,143,231,374,61,28,30,92,87,617
729,Damian Lillard,SO,2009-10,G,Weber State,Big Sky,31,1062,185,429,101,215,84,214,163,191,11,114,125,112,35,4,74,58,617
730,Ray McCallum,JR,2012-13,G,Detroit Mercy,Horizon,33,1208,214,436,172,306,42,130,147,205,43,124,167,147,64,20,68,66,617
731,Jack McClinton,SR,2008-09,G,Miami (FL),ACC,32,1030,200,445,99,222,101,223,116,131,18,81,99,91,24,1,84,52,617
732,Tim Smith,SR,2005-06,G,East Tennessee State,A-Sun,28,1056,238,530,197,405,41,125,100,137,33,94,127,126,95,1,137,45,617
733,Jordan Taylor,JR,2010-11,G,Wisconsin,Big Ten,34,1241,194,448,119,273,75,175,154,185,32,107,139,161,25,5,42,80,617
736,Desmond Williams,SR,2017-18,F,Florida A&M,MEAC,34,1212,221,504,210,463,11,41,164,222,60,148,208,64,40,25,100,78,617
737,Jeremy Wise,SO,2007-08,G,Southern Mississippi,CUSA,33,1138,189,449,148,320,41,129,198,242,15,86,101,137,39,13,112,96,617
738,Ky Bowman,SO,2017-18,G,Boston College,ACC,35,1337,220,521,140,300,80,221,96,119,29,210,239,165,51,12,112,90,616
739,Brandon Ewing,SO,2006-07,G,Wyoming,MWC,31,1146,186,423,136,256,50,167,194,241,24,76,100,95,41,2,83,87,616
740,Reggie Hamilton,JR,2010-11,G,Oakland,Summit,35,1008,207,423,125,202,82,221,120,143,27,59,86,187,46,7,127,85,616
741,Lazar Hayward,SR,2009-10,F,Marquette,Big East,34,1097,222,514,157,328,65,186,107,127,72,184,256,52,64,18,67,115,616
742,Quinton Hooker,SR,2016-17,G,North Dakota,Big Sky,32,1156,202,432,118,243,84,189,128,148,24,123,147,115,56,5,56,69,616
743,Matt Mobley,SR,2017-18,G,St. Bonaventure,A-10,34,1277,187,447,82,165,105,282,137,159,20,149,169,83,38,4,82,87,616
744,Yemi Nicholson,SR,2005-06,C,Denver,Sun Belt,31,1039,238,395,238,395,0,0,140,187,89,250,339,28,29,88,66,77,616
745,Lamar Patterson,SR,2013-14,G,Pittsburgh,ACC,36,1174,202,458,122,252,80,206,132,175,35,140,175,154,51,12,93,73,616
746,Erik Thomas,SR,2016-17,F,New Orleans,Southland,32,1043,223,379,219,362,4,17,166,212,95,155,250,73,47,11,88,68,616
747,John Wall,FR,2009-10,G,Kentucky,SEC,37,1288,202,438,165,324,37,114,175,232,30,129,159,241,66,19,149,72,616
748,Thomas Wilder,JR,2016-17,G,Western Michigan,MAC,32,1014,197,430,134,288,63,142,159,191,14,123,137,121,42,12,64,78,616
749,Will Daniels,SR,2007-08,F,Rhode Island,A-10,33,941,228,455,183,330,45,125,114,165,68,148,216,36,32,31,80,101,615
750,Malcolm Delaney,SO,2008-09,G,Virginia Tech,ACC,34,1255,160,416,90,218,70,198,225,259,34,102,136,152,50,11,97,87,615
751,Chavis Holmes,SO,2006-07,G,Virginia Military Institute,Big South,32,806,188,460,80,183,108,277,131,176,50,55,105,67,90,9,81,95,615
752,Anthony Johnson,SR,2009-10,G,Montana,Big Sky,32,1116,184,374,139,273,45,101,202,231,22,80,102,95,24,4,89,52,615
753,Camron Justice,JR,2018-19,G,IUPUI,Horizon,33,1077,195,459,105,203,90,256,135,158,11,95,106,95,43,1,84,72,615
754,Mason Plumlee,SR,2012-13,F,Duke,ACC,36,1248,221,369,221,369,0,0,173,254,98,260,358,70,36,52,103,92,615
755,Terry Rozier,SO,2014-15,G,Louisville,ACC,36,1260,214,521,166,364,48,157,139,176,43,157,200,108,72,6,79,62,615
756,Rakim Sanders,SR,2011-12,F,Fairfield,MAAC,37,1195,235,470,191,329,44,141,101,159,102,201,303,92,52,13,122,97,615
757,Anthony Smith,SR,2008-09,G,Liberty,Big South,35,1270,217,436,142,234,75,202,106,161,40,189,229,75,43,7,78,73,615
758,Thomas Walkup,SR,2015-16,G,Stephen F. Austin,Southland,34,1002,217,369,207,330,10,39,171,209,79,154,233,153,71,16,58,93,615
759,Derrick White,SR,2016-17,G,Colorado,Pac-12,34,1116,205,404,148,260,57,144,148,182,35,104,139,148,42,49,81,72,615
760,Jahii Carson,SO,2013-14,G,Arizona State,Pac-12,33,1168,211,487,175,395,36,92,156,217,24,109,133,153,23,2,116,72,614
761,Jae Crowder,SR,2011-12,F,Marquette,Big East,35,1153,217,436,156,259,61,177,119,162,70,224,294,73,88,35,44,93,614
762,Devan Downey,JR,2008-09,G,South Carolina,SEC,31,1019,231,527,179,377,52,150,100,134,19,68,87,140,89,4,108,65,614
763,LaceDarius Dunn,SO,2008-09,G,Baylor,Big 12,39,1119,194,438,85,157,109,281,117,142,50,140,190,24,42,6,70,109,614
764,Torian Graham,SR,2016-17,G,Arizona State,Pac-12,33,1147,230,513,122,234,108,279,46,56,19,120,139,39,31,11,44,51,614
765,Malcolm Hill,JR,2015-16,G,Illinois,Big Ten,34,1195,192,440,155,322,37,118,193,235,43,180,223,112,42,15,75,88,614
766,DeAndre Kane,SR,2013-14,G,Iowa State,Big 12,36,1240,208,431,165,323,43,108,155,244,49,196,245,213,44,10,104,79,614
767,Acie Law,SR,2006-07,G,Texas A&M,Big 12,34,1153,216,432,178,349,38,83,144,185,8,105,113,169,39,1,88,83,614
768,Dedric Lawson,SO,2016-17,G,Memphis,AAC,32,1104,216,469,186,358,30,111,152,205,92,225,317,105,41,68,76,81,614
769,K.J. McDaniels,JR,2013-14,F,Clemson,ACC,36,1212,209,455,167,317,42,138,154,183,86,169,255,57,41,100,83,80,614
770,Courtney Pigram,SO,2006-07,G,East Tennessee State,A-Sun,34,1141,218,535,132,297,86,238,92,135,29,106,135,127,89,3,109,65,614
771,Keifer Sykes,SR,2014-15,G,Green Bay,Horizon,33,1156,213,471,167,323,46,148,142,182,25,123,148,129,55,5,71,72,614
772,Kevin Anderson,SR,2010-11,G,Richmond,A-10,37,1339,211,494,140,320,71,174,120,160,15,87,102,122,53,4,72,56,613
773,Gerald Brown,SR,2007-08,G,Loyola (MD),MAAC,33,1037,178,453,111,262,67,191,190,240,48,111,159,63,52,5,96,117,613
774,Denis Clemente,SR,2009-10,G,Kansas State,Big 12,37,1284,213,526,125,268,88,258,99,133,24,64,88,154,40,4,72,78,613
775,Jawun Evans,SO,2016-17,G,Oklahoma State,Big 12,32,936,211,482,175,387,36,95,155,191,24,86,110,204,57,4,90,74,613
778,Jared Harper,JR,2018-19,G,Auburn,SEC,40,1318,183,459,85,194,98,265,149,180,12,87,99,231,45,2,94,70,613
779,Ricky Harris,SR,2009-10,G,Massachusetts,A-10,31,966,216,506,148,281,68,225,113,155,25,82,107,91,40,3,113,71,613
780,Desmar Jackson,SR,2013-14,G,Southern Illinois,MVC,33,1087,212,455,190,373,22,82,167,214,50,133,183,68,80,14,98,92,613
781,Fletcher Magee,SO,2016-17,G,Wofford,Southern,33,1099,196,448,84,183,112,265,109,122,10,100,110,61,24,5,55,44,613
782,Mikh McKinney,SR,2014-15,G,Sacramento State,Big Sky,32,1183,219,432,154,281,65,151,110,137,16,75,91,156,78,4,68,57,613
783,Vlad Moldoveanu,SR,2010-11,F,American,Patriot,30,1011,197,450,137,287,60,163,159,191,49,144,193,59,11,14,57,69,613
784,Brock Motum,JR,2011-12,F,Washington State,Pac-12,34,1072,220,397,191,324,29,73,144,195,62,154,216,54,19,14,103,75,613
785,Ahmad Nivins,SR,2008-09,F,Saint Joseph's,A-10,32,1259,205,335,205,334,0,1,203,258,126,252,378,32,26,56,87,70,613
786,Derek Raivio,SR,2006-07,G,Gonzaga,WCC,34,1233,190,419,105,211,85,208,148,154,22,84,106,89,50,1,61,56,613
787,Grant Riller,SO,2017-18,G,College of Charleston,CAA,33,1110,230,422,174,280,56,142,97,133,13,78,91,67,42,14,64,69,613
788,Greivis Vasquez,JR,2008-09,G,Maryland,ACC,35,1210,218,538,152,336,66,202,111,128,37,152,189,176,49,13,98,76,613
789,Brett Winkelman,SR,2008-09,F,North Dakota State,Summit,33,1088,220,438,178,332,42,106,131,162,71,178,249,58,48,12,60,62,613
790,Antoine Agudio,SR,2007-08,G,Hofstra,CAA,27,1056,207,480,123,275,84,205,114,147,15,91,106,77,31,0,96,49,612
791,Morris Almond,JR,2005-06,G,Rice,CUSA,28,905,224,448,176,340,48,108,116,146,49,65,114,32,39,19,80,66,612
792,Jordan Clarkson,JR,2013-14,G,Missouri,SEC,35,1228,209,467,177,353,32,114,162,195,28,106,134,118,38,6,93,76,612
793,Dante Cunningham,SR,2008-09,F,Villanova,Big East,38,1199,244,465,244,463,0,2,124,178,99,185,284,47,47,47,82,103,612
794,Seth Curry,SR,2012-13,G,Duke,ACC,35,1130,197,424,102,207,95,217,123,152,20,69,89,54,30,6,42,60,612
795,Brandon Ewing,SR,2008-09,G,Wyoming,MWC,33,1264,165,373,116,227,49,146,233,280,15,95,110,166,32,5,88,73,612
796,Max Heidegger,SO,2017-18,G,UC-Santa Barbara,Big West,32,1053,195,451,100,216,95,235,127,166,11,68,79,79,19,2,50,69,612
797,Stephen Maxwell,JR,2013-14,F,Cal State Northridge,Big West,35,1210,216,395,216,395,0,0,180,239,129,180,309,20,26,3,80,87,612
800,E'Twaun Moore,SR,2010-11,G,Purdue,Big Ten,34,1152,221,494,151,319,70,175,100,141,51,124,175,108,41,18,61,71,612
801,Charles Odum,SR,2011-12,G,Portland State,Big Sky,32,1005,192,363,154,251,38,112,190,228,26,98,124,82,29,7,94,72,612
802,Akeem Richmond,SR,2013-14,G,East Carolina,CUSA,34,1199,181,451,26,59,155,392,95,112,20,75,95,54,45,1,57,40,612
803,Jordon Varnado,SO,2016-17,F,Troy,Sun Belt,37,1068,233,442,205,365,28,77,118,168,76,188,264,50,19,51,70,100,612
804,A.J. Abrams,JR,2007-08,G,Texas,Big 12,37,1328,219,516,101,207,118,309,55,68,18,89,107,55,59,2,31,69,611
805,Larry Austin,SR,2018-19,G,Central Michigan,MAC,35,1191,235,473,230,454,5,19,136,248,77,142,219,209,78,5,124,93,611
806,Joe Chealey,SR,2017-18,G,College of Charleston,CAA,34,1202,169,430,107,252,62,178,211,246,22,136,158,122,29,4,59,78,611
807,Alex Harris,JR,2006-07,G,UC-Santa Barbara,Big West,29,1018,191,401,120,246,71,155,158,201,36,104,140,61,26,3,77,56,611
808,Damion James,SR,2009-10,F,Texas,Big 12,34,1029,210,419,174,325,36,94,155,230,107,243,350,33,57,40,69,100,611
809,Orlando Johnson,SR,2011-12,G,UC-Santa Barbara,Big West,31,1067,207,459,137,295,70,164,127,182,52,127,179,91,34,23,76,57,611
810,C.J. Massinburg,JR,2017-18,G,Buffalo,MAC,36,1223,196,419,107,199,89,220,130,175,80,184,264,87,40,16,58,75,611
811,Javon McCrea,JR,2012-13,F,Buffalo,MAC,34,1019,240,431,240,430,0,1,131,185,110,157,267,69,45,89,99,101,611
812,Jamie Skeen,SR,2010-11,F,Virginia Commonwealth,CAA,39,1245,198,382,162,296,36,86,179,249,93,193,286,62,23,40,66,77,611
813,J.J. Barea,SR,2005-06,G,Northeastern,CAA,29,974,209,522,143,295,66,227,126,165,31,98,129,244,37,0,136,81,610
814,Gerald Henderson,JR,2008-09,G,Duke,ACC,37,1098,213,473,172,351,41,122,143,188,46,137,183,91,46,28,80,63,610
815,Buddy Hield,JR,2014-15,G,Oklahoma,Big 12,35,1135,205,498,112,239,93,259,107,130,56,134,190,67,47,8,68,61,610
816,Cory Higgins,SR,2010-11,G,Colorado,Big 12,38,1222,200,461,164,355,36,106,174,201,31,93,124,94,37,14,80,82,610
817,Admiral Schofield,SR,2018-19,G,Tennessee,SEC,37,1175,238,502,164,325,74,177,60,86,43,184,227,75,33,17,70,94,610
818,Rayjon Tucker,JR,2018-19,G,Little Rock,Sun Belt,30,1097,187,381,115,206,72,175,164,211,23,179,202,53,33,11,78,68,610
819,Elliot Williams,SO,2009-10,G,Memphis,CUSA,34,1133,178,388,118,224,60,164,194,256,25,110,135,128,45,4,100,69,610
822,Ehab Amin,JR,2016-17,G,Texas A&M-Corpus Christi,Southland,36,1213,225,487,182,338,43,149,116,162,71,166,237,105,124,13,99,102,609
823,Charlie Brown,SO,2018-19,F,Saint Joseph's,A-10,32,1139,205,477,142,300,63,177,136,161,66,131,197,48,34,25,59,83,609
824,Derrick Colter,SR,2015-16,G,Duquesne,A-10,34,1220,193,479,113,246,80,233,143,173,17,105,122,156,34,7,108,67,609
825,Nick Faust,SR,2015-16,G,Long Beach State,Big West,35,1082,205,471,119,236,86,235,113,165,50,162,212,78,51,17,81,90,609
826,Shelvin Mack,JR,2010-11,G,Butler,Horizon,38,1219,201,493,114,247,87,246,120,156,27,143,170,131,30,3,93,66,609
827,Patrick Patterson,SO,2008-09,F,Kentucky,SEC,34,1147,240,398,240,397,0,1,129,168,92,224,316,67,21,70,66,76,609
828,Jamine Peterson,SO,2009-10,F,Providence,Big East,31,941,233,500,182,352,51,148,92,164,135,180,315,36,39,26,57,80,609
829,Marcus Posley,SR,2015-16,G,St. Bonaventure,A-10,31,1154,197,471,115,243,82,228,133,165,21,85,106,113,39,3,75,76,609
830,Ronshad Shabazz,JR,2017-18,G,Appalachian State,Sun Belt,33,1079,206,515,126,282,80,233,117,170,19,64,83,100,36,2,79,58,609
831,Kyle Singler,SO,2008-09,F,Duke,ACC,37,1193,208,472,139,292,69,180,124,174,112,172,284,89,57,38,92,99,609
832,Sean Singletary,JR,2006-07,G,Virginia,ACC,32,1064,170,425,91,222,79,203,190,218,36,111,147,151,38,1,100,81,609
833,Klay Thompson,SO,2009-10,G,Washington State,Pac-10,31,1096,200,485,124,276,76,209,133,166,37,122,159,70,44,22,104,75,609
834,Arron Afflalo,JR,2006-07,G,UCLA,Pac-10,36,1186,210,456,123,224,87,232,101,126,15,84,99,70,22,8,64,66,608
835,Mark Alstork,JR,2016-17,G,Wright State,Horizon,32,965,181,452,111,271,70,181,176,208,26,124,150,112,25,19,136,92,608
836,Jarekious Bradley,JR,2013-14,G,Southeast Missouri State,OVC,32,1003,218,438,143,237,75,201,97,125,48,153,201,52,38,30,57,95,608
837,C.J. Bryce,SO,2016-17,G,North Carolina-Wilmington,CAA,35,1199,231,477,189,350,42,127,104,153,60,129,189,104,33,7,66,80,608
838,Reger Dowell,SR,2013-14,G,Texas-Arlington,Sun Belt,30,928,194,479,98,208,96,271,124,162,8,67,75,66,21,2,74,74,608
839,Matt Howard,SR,2010-11,F,Butler,Horizon,37,1148,188,399,135,266,53,133,179,226,98,187,285,53,41,23,62,108,608
840,Cameron Johnson,SR,2018-19,G,North Carolina,ACC,36,1076,211,417,115,207,96,210,90,110,66,142,208,86,43,10,54,53,608
841,Micah Mason,SR,2015-16,G,Duquesne,A-10,33,1177,207,441,89,162,118,279,76,91,7,94,101,148,31,2,69,63,608
844,Cameron Morse,SO,2015-16,G,Youngstown State,Horizon,30,1006,201,427,137,272,64,155,142,175,10,72,82,92,46,2,52,47,608
845,Josh Robinson,SO,2015-16,G,Austin Peay,OVC,36,1228,185,461,113,250,72,211,166,199,14,98,112,92,36,0,97,49,608
846,Keifer Sykes,JR,2013-14,G,Green Bay,Horizon,30,1029,195,416,165,319,30,97,188,232,22,111,133,147,37,0,64,52,608
847,Marcus Thornton,JR,2007-08,G,Louisiana State,SEC,31,1043,212,486,122,247,90,239,94,115,63,111,174,42,43,10,68,62,608
848,Ben Uzoh,SO,2007-08,G,Tulsa,CUSA,39,1258,208,426,153,269,55,157,137,170,64,148,212,88,39,29,92,62,608
849,Devin Watson,SO,2015-16,G,San Francisco,WCC,30,1041,192,459,127,273,65,186,159,217,9,65,74,146,27,0,89,53,608
850,Joe Alexander,JR,2007-08,G,West Virginia,Big East,36,1137,219,474,208,433,11,41,158,194,68,163,231,88,26,54,80,103,607
851,DeMario Anderson,SR,2007-08,G,Quinnipiac,NEC,28,924,220,492,185,398,35,94,132,164,29,152,181,91,43,12,116,82,607
852,Keith Benson,JR,2009-10,C,Oakland,Summit,35,1095,208,390,206,385,2,5,189,261,111,256,367,28,15,117,58,104,607
853,Marqus Blakely,SR,2009-10,F,Vermont,AEC,35,1180,202,373,201,358,1,15,202,303,113,214,327,129,85,67,121,89,607
854,Allen Crabbe,JR,2012-13,G,University of California,Pac-12,33,1195,215,468,151,284,64,184,113,139,33,167,200,87,37,23,83,69,607
855,JamesOn Curry,JR,2006-07,G,Oklahoma State,Big 12,35,1295,202,447,114,233,88,214,115,145,15,96,111,131,41,11,109,74,607
856,Yogi Ferrell,SR,2015-16,G,Indiana,Big Ten,35,1215,196,428,117,240,79,188,136,164,34,99,133,195,38,1,88,58,607
857,Brandon Heath,JR,2005-06,G,San Diego State,MWC,33,1164,204,481,106,241,98,240,101,119,21,90,111,114,49,1,119,54,607
858,Garrison Carr,JR,2007-08,G,American,Patriot,33,1187,190,448,55,149,135,299,91,102,22,89,111,57,23,1,73,61,606
859,Adrien Coleman,JR,2012-13,G,Bethune-Cookman,MEAC,34,1220,233,432,225,397,8,35,132,262,107,144,251,100,46,15,99,85,606
860,Juan'ya Green,SR,2015-16,G,Hofstra,CAA,34,1282,173,435,105,247,68,188,192,240,25,123,148,243,56,17,101,78,606
861,Ken Horton,JR,2010-11,F,Central Connecticut State,NEC,31,1096,214,435,155,278,59,157,119,137,92,183,275,60,44,50,51,74,606
862,Justin James,JR,2017-18,G,Wyoming,MWC,32,996,210,445,170,315,40,130,146,201,19,172,191,98,36,16,81,81,606
863,Tyler Ulis,SO,2015-16,G,Kentucky,SEC,35,1288,192,442,137,282,55,160,167,195,19,86,105,246,51,4,69,64,606
864,Joel Wright,JR,2012-13,F,Texas State,WAC,34,911,194,423,177,370,17,53,201,261,90,143,233,57,44,20,123,132,606
865,Brandon Costner,FR,2006-07,F,North Carolina State,ACC,36,1239,193,407,132,246,61,161,158,219,55,209,264,64,29,26,112,103,605
866,Melvin Ejim,SR,2013-14,F,Iowa State,Big 12,34,1093,220,436,176,309,44,127,121,159,88,197,285,62,40,23,78,111,605
867,Kenneth Faried,SR,2010-11,F,Morehead State,OVC,35,1216,233,374,233,374,0,0,139,241,200,308,508,37,67,82,92,108,605
868,James Harden,FR,2007-08,G,Arizona State,Pac-10,34,1158,196,372,152,264,44,108,169,224,44,135,179,110,73,19,89,72,605
869,Kyle Hines,JR,2006-07,F,North Carolina-Greensboro,Southern,29,928,233,420,232,414,1,6,138,230,99,161,260,26,40,64,74,83,605
870,Quincy McKnight,SO,2016-17,G,Sacred Heart,NEC,32,1040,203,473,176,389,27,84,172,222,26,130,156,95,52,5,148,94,605
871,Paul Miller,SR,2017-18,G,North Dakota State,Summit,31,1048,208,461,141,264,67,197,122,146,15,165,180,105,31,10,95,50,605
872,Jamal Olasewere,SR,2012-13,F,Long Island University,NEC,32,969,200,389,180,327,20,62,185,267,66,208,274,43,48,20,110,108,605
873,Tookie Brown,JR,2017-18,G,Georgia Southern,Sun Belt,32,1035,189,355,140,251,49,104,177,235,20,110,130,137,56,10,80,79,604
874,Raiquan Clark,SR,2018-19,G,Long Island University,NEC,32,1034,220,437,200,355,20,82,144,206,62,154,216,63,40,21,142,100,604
875,Raiquan Clark,JR,2017-18,G,Long Island University,NEC,35,1127,207,372,200,343,7,29,183,244,74,171,245,53,40,14,143,111,604
876,Michael Glover,SR,2011-12,F,Iona,MAAC,33,1109,239,375,239,375,0,0,126,194,106,191,297,32,33,38,88,97,604
877,Ryan Harrow,JR,2013-14,G,Georgia State,Sun Belt,34,1152,222,498,192,394,30,104,130,155,23,66,89,144,43,2,57,43,604
878,Xavier Hill-Mais,JR,2018-19,F,Oakland,Horizon,33,1025,235,439,201,338,34,101,100,143,73,164,237,81,21,26,96,90,604
879,R.J. Hunter,SO,2013-14,G,Georgia State,Sun Belt,33,1106,181,408,81,155,100,253,142,161,11,140,151,57,63,31,39,77,604
880,Dior Lowhorn,JR,2008-09,F,San Francisco,WCC,30,970,231,478,193,390,38,88,104,153,67,140,207,23,16,17,45,59,604
881,Jairus Lyles,JR,2016-17,G,Maryland-Baltimore County,AEC,32,1107,210,475,165,334,45,141,139,191,42,169,211,83,54,1,71,50,604
882,Darrel Mitchell,SR,2005-06,G,Louisiana State,SEC,36,1322,200,459,118,251,82,208,122,161,30,104,134,160,70,11,99,81,604
883,Tyler Nelson,JR,2016-17,G,Fairfield,MAAC,31,1119,196,442,115,235,81,207,131,153,23,75,98,112,35,4,69,53,604
886,D.J. Newbill,JR,2013-14,G,Penn State,Big Ten,34,1171,209,462,163,321,46,141,140,186,61,106,167,58,27,11,72,96,604
887,Martin Samarco,SR,2006-07,F,Bowling Green State,MAC,31,1113,200,506,120,263,80,243,124,161,21,92,113,70,29,5,74,74,604
888,Donald Sloan,SR,2009-10,G,Texas A&M,Big 12,34,1130,200,450,153,321,47,129,157,204,23,99,122,79,22,2,80,56,604
889,Lamar Stevens,SO,2017-18,F,Penn State,Big Ten,39,1290,231,497,201,403,30,94,112,161,54,178,232,74,24,43,87,93,604
890,Martez Walker,JR,2016-17,G,Oakland,Horizon,34,1146,195,446,124,221,71,225,143,172,48,89,137,49,30,12,63,61,604
891,Nate Wolters,SO,2010-11,G,South Dakota State,Summit,31,1029,201,449,159,346,42,103,160,201,32,110,142,188,41,7,68,63,604
892,Dwayne Bacon,SO,2016-17,G,Florida State,ACC,35,1008,221,489,164,318,57,171,104,138,35,112,147,61,35,4,71,55,603
893,John Brown,SO,2013-14,F,High Point,Big South,31,986,224,411,224,406,0,5,155,208,105,134,239,60,47,51,49,79,603
894,Gilberto Clavell,SR,2010-11,F,Sam Houston State,Southland,31,934,213,381,211,374,2,7,175,247,100,125,225,28,20,4,97,107,603
895,Nick Dixon,JR,2016-17,G,Texas-Rio Grande Valley,WAC,32,877,201,386,173,300,28,86,173,226,49,113,162,109,60,2,93,75,603
896,Dwight Hardy,SR,2010-11,G,St. John's (NY),Big East,33,1129,194,433,132,258,62,175,153,181,26,71,97,62,42,3,73,59,603
897,Malcolm Hill,SR,2016-17,G,Illinois,Big Ten,35,1164,189,435,124,252,65,183,160,204,35,145,180,102,42,13,66,74,603
898,Jeremy Lamb,SO,2011-12,G,Connecticut,Big East,34,1266,217,454,146,243,71,211,98,121,32,134,166,58,42,21,68,57,603
899,Dominique Morrison,JR,2010-11,F,Oral Roberts,Summit,31,1083,207,403,167,304,40,99,149,191,41,114,155,66,20,15,51,84,603
900,Darrion Pellum,SR,2011-12,G,Hampton,MEAC,33,1272,196,542,124,299,72,243,139,184,20,119,139,55,40,10,105,67,603
901,Jahaad Proctor,JR,2018-19,G,High Point,Big South,31,1073,210,453,155,287,55,166,128,166,18,101,119,101,39,11,68,50,603
902,Jerome Randle,JR,2008-09,G,University of California,Pac-10,33,1164,191,381,109,204,82,177,139,161,14,86,100,165,24,0,95,58,603
903,Devon Saddler,SO,2011-12,G,Delaware,CAA,32,1130,193,493,134,303,59,190,158,197,22,108,130,56,24,11,102,82,603
904,Thomas Wilder,SR,2017-18,G,Western Michigan,MAC,32,1050,191,443,144,298,47,145,174,207,23,118,141,138,62,10,79,72,603
905,Wayne Ellington,JR,2008-09,G,North Carolina,ACC,38,1155,215,445,130,241,85,204,87,112,57,129,186,101,36,6,62,57,602
908,Tim Frazier,JR,2011-12,G,Penn State,Big Ten,32,1188,208,497,181,411,27,86,159,201,44,106,150,198,76,7,117,94,602
909,Langston Galloway,SR,2013-14,G,Saint Joseph's,A-10,34,1231,190,428,82,184,108,244,114,138,28,117,145,53,36,17,28,81,602
910,Andrew Goudelock,SO,2008-09,G,College of Charleston,Southern,36,1120,221,481,126,265,95,216,65,75,18,72,90,67,26,11,69,44,602
911,Tarence Kinsey,SR,2005-06,G,South Carolina,SEC,38,1321,209,461,138,272,71,189,113,134,54,120,174,88,61,13,78,84,602
912,Marcquise Reed,SR,2018-19,G,Clemson,ACC,31,1098,202,459,154,324,48,135,150,178,23,149,172,95,66,1,83,60,602
913,Scottie Reynolds,SR,2009-10,G,Villanova,Big East,33,1000,181,396,112,217,69,179,171,204,17,72,89,108,51,4,87,68,602
914,Zack Rosen,SR,2011-12,G,Pennsylvania,Ivy,33,1259,211,466,136,278,75,188,105,119,9,97,106,173,46,2,90,76,602
915,Devin Sibley,JR,2016-17,G,Furman,Southern,34,1093,201,385,122,209,79,176,121,162,9,131,140,78,26,7,91,68,602
916,Khalil Small,SR,2017-18,G,Green Bay,Horizon,33,1130,201,454,148,316,53,138,147,177,69,153,222,110,43,4,88,85,602
917,Andrew Warren,SR,2010-11,G,Bradley,MVC,32,1173,196,473,120,278,76,195,134,156,38,137,175,59,54,10,57,90,602
918,Chris Warren,JR,2009-10,G,Mississippi,SEC,35,1152,192,451,81,176,111,275,107,131,6,63,69,124,37,5,79,57,602
919,Antwan Carter,SR,2011-12,C,Longwood,Ind,31,1055,245,480,222,405,23,75,88,123,78,207,285,41,30,27,72,98,601
920,Ian Clark,SR,2012-13,G,Belmont,OVC,33,1102,217,400,115,178,102,222,65,78,12,96,108,79,53,8,88,64,601
921,De'Aaron Fox,FR,2016-17,G,Kentucky,SEC,36,1064,214,447,197,378,17,69,156,212,21,122,143,165,53,7,87,90,601
922,Marcus Georges-Hunt,SR,2015-16,F,Georgia Tech,ACC,36,1167,178,392,138,275,40,117,205,249,32,90,122,119,31,16,73,94,601
923,Justin Gray,SR,2005-06,G,Wake Forest,ACC,33,1156,180,490,85,227,95,263,146,175,17,103,120,141,33,4,111,82,601
924,Draymond Green,SR,2011-12,F,Michigan State,Big Ten,37,1229,212,472,160,338,52,134,125,173,79,315,394,141,54,35,112,105,601
925,Stephan Hicks,JR,2013-14,G,Cal State Northridge,Big West,35,1198,206,397,196,364,10,33,179,218,73,164,237,37,47,10,55,86,601
926,Aaron Nixon,SR,2006-07,G,Long Beach State,Big West,32,1055,198,479,117,272,81,207,124,166,36,120,156,100,43,10,87,84,601
927,James Sinclair,SR,2014-15,G,Western Carolina,Southern,31,1180,214,532,163,370,51,162,122,159,58,129,187,90,67,14,76,65,601
930,Jalan West,SO,2013-14,G,Northwestern State,Southland,31,1021,184,397,114,226,70,171,163,186,14,111,125,197,78,8,84,75,601
931,Da'Sean Butler,JR,2008-09,F,West Virginia,Big East,35,1160,212,494,150,317,62,177,114,150,76,132,208,60,45,10,81,88,600
932,Dionte Christmas,SO,2006-07,G,Temple,A-10,30,1029,192,412,104,192,88,220,128,147,27,99,126,62,41,11,73,77,600
933,Jeremy Crouch,SR,2007-08,G,Bradley,MVC,38,1315,194,460,76,164,118,296,94,108,17,121,138,122,57,3,87,83,600
934,Jared Dudley,JR,2005-06,F,Boston College,ACC,36,1340,198,401,165,307,33,94,171,241,96,143,239,115,41,12,70,57,600
935,Troy Jackson,JR,2008-09,G,Alcorn State,SWAC,30,1114,193,455,157,317,36,138,178,230,36,104,140,95,75,13,71,60,600
936,Robert Vaden,SR,2008-09,G,Alabama-Birmingham,CUSA,34,1240,207,522,95,198,112,324,74,100,24,144,168,70,35,21,84,61,600
937,Amir Coffey,JR,2018-19,G,Minnesota,Big Ten,36,1267,198,454,157,319,41,135,162,219,25,106,131,115,33,8,83,54,599
938,Trey Davis,SR,2015-16,G,Massachusetts,A-10,32,1087,184,470,101,243,83,227,148,169,20,127,147,103,38,4,91,64,599
939,Keon Johnson,JR,2015-16,G,Winthrop,Big South,32,1100,178,395,100,196,78,199,165,198,17,116,133,81,29,0,69,62,599
940,Cartier Martin,SR,2006-07,F,Kansas State,Big 12,35,963,197,428,119,226,78,202,127,159,69,86,155,45,24,8,58,94,599
941,Kevin Palmer,JR,2008-09,G,Texas A&M-Corpus Christi,Southland,33,987,190,445,136,271,54,174,165,204,56,114,170,94,86,18,111,63,599
942,Julius Randle,FR,2013-14,F,Kentucky,SEC,40,1233,196,391,193,373,3,18,204,289,139,277,416,57,20,31,101,91,599
943,Marcus Thornton,JR,2013-14,G,William & Mary,CAA,32,1139,195,448,102,217,93,231,116,149,7,66,73,90,34,7,76,57,599
944,Kevin Anderson,SO,2008-09,G,Richmond,A-10,36,1323,215,469,181,351,34,118,134,179,29,74,103,101,48,2,84,81,598
945,Brandon Bowdry,SR,2010-11,F,Eastern Michigan,MAC,30,967,205,460,177,379,28,81,160,235,71,213,284,55,32,9,97,74,598
946,Antonio Campbell,JR,2015-16,F,Ohio,MAC,35,1013,237,423,194,306,43,117,81,111,74,283,357,23,23,63,44,111,598
947,Quinn Cook,SR,2014-15,G,Duke,ACC,39,1396,199,439,97,181,102,258,98,110,15,116,131,103,39,1,47,76,598
948,Eric Eaves,JR,2015-16,G,South Carolina State,MEAC,34,961,196,376,170,304,26,72,180,236,26,69,95,66,27,8,79,69,598
949,Kay Felder,SO,2014-15,G,Oakland,Horizon,33,1272,183,434,136,295,47,139,185,224,25,133,158,252,66,8,137,83,598
952,Tre'Shaun Fletcher,SR,2017-18,G,Toledo,MAC,33,1087,205,443,156,303,49,140,139,195,59,205,264,142,27,7,79,75,598
953,Isaiah Johnson,SR,2016-17,C,Akron,MAC,36,1076,223,357,223,355,0,2,152,259,103,154,257,103,17,33,84,95,598
954,Christian Lutete,JR,2018-19,G,Massachusetts-Lowell,AEC,32,1085,213,399,143,222,70,177,102,142,42,202,244,45,22,3,80,61,598
955,Denzel Mahoney,SO,2017-18,G,Southeast Missouri State,OVC,31,970,176,380,112,225,64,155,182,218,45,113,158,39,28,5,51,91,598
956,Brandon Paul,SR,2012-13,G,Illinois,Big Ten,36,1153,184,459,106,219,78,240,152,206,22,135,157,98,44,23,96,86,598
957,Courtney Pigram,SR,2008-09,G,East Tennessee State,A-Sun,34,1183,214,550,138,317,76,233,94,131,24,92,116,138,58,6,113,70,598
958,Juwan Staten,JR,2013-14,G,West Virginia,Big 12,33,1231,205,423,199,408,6,15,182,253,28,158,186,193,41,3,69,52,598
959,Travis Trice,SR,2014-15,G,Michigan State,Big Ten,39,1309,195,491,105,247,90,244,118,165,18,105,123,197,40,6,69,70,598
960,Allonzo Trier,JR,2017-18,G,Arizona,Pac-12,33,1124,184,368,114,184,70,184,160,185,11,89,100,107,21,11,70,57,598
961,Gary Wilkinson,SR,2008-09,F,Utah State,WAC,35,1122,213,367,207,348,6,19,166,201,59,179,238,44,16,13,54,64,598
962,Solomon Bozeman,SR,2010-11,G,Little Rock,Sun Belt,36,1100,153,353,88,211,65,142,226,280,16,60,76,99,25,2,92,82,597
963,Jared Brownridge,SR,2016-17,G,Santa Clara,WCC,33,1223,190,464,84,177,106,287,111,137,9,80,89,93,32,4,55,69,597
964,Jimmy Gavin,SR,2015-16,G,Winthrop,Big South,32,1080,196,410,102,181,94,229,111,134,16,78,94,95,26,2,66,57,597
965,Justin Hawkins,SR,2007-08,G,New Mexico State,WAC,33,1093,199,421,157,316,42,105,157,201,84,154,238,78,32,16,92,89,597
966,Kevin Hervey,JR,2016-17,F,Texas-Arlington,Sun Belt,35,973,208,453,140,255,68,198,113,150,49,249,298,74,43,14,66,65,597
967,Brock Motum,SR,2012-13,F,Washington State,Pac-12,32,1131,216,474,171,340,45,134,120,162,61,140,201,35,20,26,77,74,597
968,Marc Eddy Norelia,JR,2015-16,F,Florida Gulf Coast,A-Sun,35,1148,234,429,234,427,0,2,129,192,107,218,325,45,39,28,63,73,597
969,Jerome Robinson,SO,2016-17,G,Boston College,ACC,32,1089,213,503,159,341,54,162,117,162,20,104,124,108,55,12,102,89,597
970,Derrick Rose,FR,2007-08,G,Memphis,CUSA,40,1168,208,436,173,332,35,104,146,205,54,127,181,189,48,15,107,68,597
971,Rodrick Sikes,JR,2017-18,G,South Alabama,Sun Belt,32,998,178,421,90,183,88,238,153,197,13,86,99,27,30,7,60,60,597
972,Will Whittington,SR,2006-07,G,Marist,MAAC,34,1272,179,456,42,111,137,345,102,128,29,84,113,58,34,5,58,78,597
973,Andrew Wiggins,FR,2013-14,G,Kansas,Big 12,35,1148,189,422,146,296,43,126,176,227,76,129,205,54,41,34,80,94,597
974,Davion Berry,SR,2013-14,G,Weber State,Big Sky,31,1031,163,351,102,194,61,157,209,254,13,118,131,122,30,6,86,70,596
975,John Bryant,SR,2008-09,C,Santa Clara,WCC,33,1023,226,379,226,378,0,1,144,183,140,327,467,35,17,84,82,84,596
976,Cameron Forte,SR,2015-16,F,Portland State,Big Sky,31,907,244,421,243,419,1,2,107,194,106,182,288,80,30,15,99,65,596
977,Kyle Hines,SR,2007-08,F,North Carolina-Greensboro,Southern,31,1002,235,423,234,415,1,8,125,199,122,159,281,43,56,95,103,86,596
978,Anthony Ireland,SR,2013-14,G,Loyola Marymount,WCC,32,1127,192,470,150,336,42,134,170,208,39,80,119,173,53,3,90,76,596
979,Chavaughn Lewis,SR,2014-15,G,Marist,MAAC,29,1034,203,491,162,349,41,142,149,224,26,129,155,78,67,22,104,71,596
980,Mike Muscala,JR,2011-12,F,Bucknell,Patriot,35,1047,193,384,186,364,7,20,203,238,97,222,319,63,16,59,72,87,596
981,Josh Okogie,FR,2016-17,G,Georgia Tech,ACC,37,1141,194,428,166,355,28,73,180,241,55,146,201,61,48,27,77,94,596
982,Marcus Paige,SO,2013-14,G,North Carolina,ACC,34,1211,191,434,105,213,86,221,128,146,18,91,109,143,51,7,73,68,596
983,Jordan Price,JR,2015-16,G,La Salle,A-10,31,1170,195,500,106,256,89,244,117,163,23,149,172,92,35,13,102,68,596
984,Andrew Rowsey,SO,2014-15,G,North Carolina-Asheville,Big South,31,1010,177,449,75,182,102,267,140,152,19,67,86,89,44,2,70,67,596
985,Angelo Warner,JR,2013-14,G,Morehead State,OVC,34,1184,183,410,127,238,56,172,174,212,54,109,163,103,67,10,89,96,596
986,Alan Williams,JR,2013-14,C,UC-Santa Barbara,Big West,28,872,224,420,224,420,0,0,148,216,106,216,322,33,33,67,59,84,596
987,Ryan Wittman,SR,2009-10,F,Cornell,Ivy,34,1149,208,439,99,184,109,255,71,86,17,118,135,62,36,12,57,63,596
988,Alex Francis,SR,2013-14,F,Bryant,NEC,32,1152,225,390,225,390,0,0,145,236,85,177,262,46,37,26,97,93,595
989,Jonathan Gibson,SR,2009-10,G,New Mexico State,WAC,34,1109,197,441,91,180,106,261,95,112,17,81,98,95,47,2,73,69,595
990,Tu Holloway,SR,2011-12,G,Xavier,A-10,34,1247,166,387,121,257,45,130,218,253,14,110,124,166,52,3,102,73,595
991,Delroy James,SR,2010-11,F,Rhode Island,A-10,34,1160,213,487,181,360,32,127,137,186,92,175,267,91,54,39,115,98,595
994,Justin Johnson,SR,2017-18,F,Western Kentucky,CUSA,38,1314,239,464,192,351,47,113,70,123,84,276,360,48,27,28,57,69,595
995,Terrence Jones,FR,2010-11,F,Kentucky,SEC,38,1196,206,466,180,387,26,79,157,243,92,244,336,60,43,72,75,91,595
996,Brian Laing,SR,2007-08,G,Seton Hall,Big East,32,1225,218,479,181,380,37,99,122,152,60,161,221,63,50,16,78,90,595
997,Sa'eed Nelson,JR,2018-19,G,American,Patriot,30,1095,203,400,177,315,26,85,163,227,29,138,167,155,71,16,109,69,595
998,Eric Paschall,SR,2018-19,F,Villanova,Big East,36,1301,195,436,125,235,70,201,135,181,46,175,221,77,26,17,82,77,595
999,QJ Peterson,JR,2015-16,G,Virginia Military Institute,Southern,30,1006,189,467,106,237,83,230,134,148,49,140,189,83,42,15,82,67,595
1000,A.J. Slaughter,SR,2009-10,G,Western Kentucky,Sun Belt,34,1240,184,442,105,222,79,220,148,179,16,92,108,147,54,4,92,63,595
1001,Denzel Valentine,SR,2015-16,G,Michigan State,Big Ten,31,1022,205,444,101,210,104,234,81,95,25,208,233,241,32,7,85,52,595
1002,Kori Babineaux,SR,2015-16,G,Jacksonville,A-Sun,32,1149,257,549,248,516,9,33,71,113,22,133,155,123,31,5,90,75,594
1003,Roy Booker,SR,2005-06,G,Southeast Missouri State,OVC,27,964,178,504,105,271,73,233,165,200,49,80,129,47,17,1,77,67,594
1004,Pat Calathes,SR,2007-08,G,Saint Joseph's,A-10,34,1143,189,422,115,237,74,185,142,172,66,189,255,92,42,42,78,92,594
1005,Dikembe Dixson,FR,2015-16,F,Illinois-Chicago,Horizon,30,1102,192,520,151,385,41,135,169,256,43,177,220,55,35,14,124,77,594
1006,Kelvin Lewis,JR,2008-09,G,Houston,CUSA,33,1218,195,473,102,221,93,252,111,133,24,84,108,43,51,5,47,65,594
1007,P.J. Tucker,JR,2005-06,F,Texas,Big 12,37,1276,225,437,223,434,2,3,142,190,105,248,353,106,66,13,115,105,594
1008,Corey Walden,SR,2014-15,G,Eastern Kentucky,OVC,32,1108,198,362,147,222,51,140,147,180,27,100,127,123,99,5,71,79,594
1009,Dominic Waters,SR,2009-10,G,Portland State,Big Sky,32,1079,193,398,123,233,70,165,138,153,9,64,73,151,25,1,113,82,594
1010,Cody Zeller,SO,2012-13,F,Indiana,Big Ten,36,1062,199,353,199,351,0,2,196,259,101,188,289,47,37,45,81,80,594
1011,Vaughn Duggins,SR,2010-11,G,Wright State,Horizon,33,1160,202,452,165,333,37,119,152,185,33,94,127,72,50,3,54,55,593
1012,Kellan Grady,FR,2017-18,G,Davidson,A-10,33,1163,219,437,146,241,73,196,82,102,23,85,108,64,27,3,32,68,593
1013,Javonte Green,JR,2013-14,F,Radford,Big South,35,897,212,387,200,352,12,35,157,229,81,204,285,37,68,21,56,97,593
1016,Matt Mobley,JR,2016-17,G,St. Bonaventure,A-10,32,1226,176,419,90,192,86,227,155,180,16,171,187,82,50,10,74,78,593
1017,Keon Moore,SR,2014-15,G,Winthrop,Big South,32,1058,188,424,87,190,101,234,116,135,25,141,166,56,44,8,59,62,593
1018,Brandon Polk,SR,2005-06,F,Butler,Horizon,33,1041,232,403,231,399,1,4,128,204,65,89,154,42,21,50,62,80,593
1019,Dewayne Russell,SR,2016-17,G,Grand Canyon,WAC,28,1072,197,492,145,361,52,131,147,194,13,92,105,151,41,4,75,60,593
1020,Sidney Sanders,SR,2013-14,G,Fairleigh Dickinson,NEC,31,1041,202,486,171,397,31,89,158,210,32,85,117,181,67,0,78,84,593
1021,Ahmad Thomas,JR,2016-17,G,North Carolina-Asheville,Big South,33,1088,243,447,206,366,37,81,70,123,46,172,218,77,99,15,69,85,593
1022,Isaiah Thomas,SO,2009-10,G,Washington,Pac-10,35,1089,186,448,121,249,65,199,156,213,20,117,137,111,37,3,83,67,593
1023,Tristan Thompson,SR,2010-11,G,North Texas,Sun Belt,33,1056,158,344,92,186,66,158,211,253,16,89,105,59,24,4,74,62,593
1024,Jimmy Baron,SR,2008-09,G,Rhode Island,A-10,34,1106,200,430,82,170,118,260,74,83,33,58,91,65,23,4,44,52,592
1025,Jerryd Bayless,FR,2007-08,G,Arizona,Pac-10,30,1072,173,378,114,233,59,145,187,223,13,69,82,121,29,3,89,66,592
1026,Ryan Boatright,SR,2014-15,G,Connecticut,AAC,34,1216,182,430,96,221,86,209,142,167,15,124,139,129,46,8,81,64,592
1027,Calvin Cage,SR,2005-06,G,Buffalo,MAC,32,1138,178,440,89,223,89,217,147,177,18,79,97,80,43,1,96,69,592
1028,Bakari Copeland,SR,2016-17,F,Maryland-Eastern Shore,MEAC,34,1028,194,417,154,322,40,95,164,213,39,169,208,56,19,7,78,85,592
1029,Randy Culpepper,JR,2009-10,G,Texas-El Paso,CUSA,33,1100,201,426,119,203,82,223,108,147,24,68,92,63,59,9,58,62,592
1030,Zabian Dowdell,SR,2006-07,G,Virginia Tech,ACC,34,1148,197,426,153,312,44,114,154,191,27,95,122,106,71,7,67,52,592
1031,Olivier Hanlan,SO,2013-14,G,Boston College,ACC,32,1160,173,387,112,211,61,176,185,228,12,98,110,93,25,2,78,82,592
1032,Justin James,SO,2016-17,G,Wyoming,MWC,37,974,198,429,149,312,49,117,147,193,43,141,184,80,29,20,92,95,592
1033,Vasa Pusica,JR,2017-18,G,Northeastern,CAA,33,1132,189,375,113,197,76,178,138,171,9,111,120,168,36,4,113,74,592
1034,Dar Tucker,SO,2008-09,F,DePaul,Big East,32,1038,203,520,145,316,58,204,128,182,50,123,173,48,45,12,90,71,592
1035,A.D. Vassallo,JR,2007-08,G,Virginia Tech,ACC,35,1201,206,465,121,250,85,215,95,125,27,133,160,77,24,16,87,78,592
1038,Wink Adams,JR,2007-08,G,Nevada-Las Vegas,MWC,35,1092,187,443,121,258,66,185,151,178,19,120,139,107,52,1,64,63,591
1039,Kentavious Caldwell-Pope,SO,2012-13,G,Georgia,SEC,32,1086,186,430,102,205,84,225,135,169,37,189,226,58,65,17,64,70,591
1040,Cleanthony Early,SR,2013-14,F,Wichita State,MVC,36,986,187,386,121,209,66,177,151,179,48,165,213,27,29,28,70,83,591
1041,Trey Freeman,JR,2014-15,G,Old Dominion,CUSA,35,1131,221,502,174,370,47,132,102,140,20,132,152,125,46,4,59,54,591
1042,A.J. Graves,JR,2006-07,G,Butler,Horizon,35,1247,174,464,76,187,98,277,145,153,14,66,80,85,51,2,59,55,591
1043,Velton Jones,JR,2011-12,G,Robert Morris,NEC,37,1096,162,457,102,271,60,186,207,270,29,75,104,167,68,1,99,107,591
1044,Gabe Levin,SR,2017-18,F,Long Beach State,Big West,32,991,194,426,171,365,23,61,180,221,68,164,232,52,32,22,93,85,591
1045,Maodo Lo,SR,2015-16,G,Columbia,Ivy,35,1144,212,467,116,210,96,257,71,101,27,108,135,100,78,14,75,73,591
1046,Andrew Nicholson,SR,2011-12,F,St. Bonaventure,A-10,32,962,220,385,197,332,23,53,128,165,83,186,269,33,21,63,80,90,591
1047,Norman Powell,SR,2014-15,G,UCLA,Pac-12,36,1244,213,467,175,348,38,119,127,169,21,148,169,75,66,16,80,91,591
1048,Allan Ray,SR,2005-06,G,Villanova,Big East,32,1026,186,478,79,190,107,288,112,126,19,96,115,56,37,3,59,77,591
1049,Breein Tyree,JR,2018-19,G,Mississippi,SEC,33,1117,197,429,128,245,69,184,128,154,11,86,97,92,32,14,80,65,591
1050,David Walker,SR,2015-16,G,Northeastern,CAA,33,1263,179,399,82,164,97,235,136,157,19,108,127,131,47,12,62,30,591
1051,Casper Ware,SR,2011-12,G,Long Beach State,Big West,34,1146,189,471,95,207,94,264,119,150,13,69,82,114,46,3,81,64,591
1052,Barry Brown,JR,2017-18,G,Kansas State,Big 12,37,1285,203,453,161,321,42,132,142,184,22,94,116,120,67,5,95,81,590
1053,Kenneth Faried,JR,2009-10,F,Morehead State,OVC,35,1060,224,397,223,393,1,4,141,237,148,308,456,19,56,67,84,115,590
1054,Ethan Happ,JR,2017-18,F,Wisconsin,Big Ten,33,1017,242,458,241,447,1,11,105,191,78,187,265,122,49,35,93,87,590
1055,Manny Harris,SO,2008-09,G,Michigan,Big Ten,35,1152,181,436,129,277,52,159,176,204,62,175,237,154,43,18,110,72,590
1056,Charles Hinkle,SR,2011-12,F,American,Patriot,32,1098,175,431,90,228,85,203,155,185,33,141,174,58,30,14,68,66,590
1057,Brandon Johnson,JR,2007-08,G,San Diego,WCC,35,1230,207,496,127,282,80,214,96,153,22,123,145,124,77,2,116,78,590
1060,Tywain McKee,SR,2008-09,G,Coppin State,MEAC,32,1177,194,480,127,294,67,186,135,167,41,142,183,131,91,3,97,72,590
1061,Stuckey Mosley,JR,2017-18,G,James Madison,CAA,32,1140,199,482,114,251,85,231,107,127,24,119,143,68,46,7,63,80,590
1062,Patrick Richard,SR,2011-12,G,McNeese State,Southland,33,1204,190,473,140,294,50,179,160,208,63,147,210,109,43,22,80,78,590
1063,Josh Robinson,JR,2016-17,G,Austin Peay,OVC,29,1062,187,426,116,232,71,194,145,176,10,76,86,101,28,4,74,55,590
1064,Tyler Smith,JR,2008-09,F,Tennessee,SEC,34,1107,196,446,168,350,28,96,170,222,70,126,196,114,25,7,70,72,590
1065,Brad Waldow,SR,2014-15,F,Saint Mary's (CA),WCC,31,1068,235,421,235,421,0,0,120,182,90,193,283,69,16,23,66,73,590
1066,Charles Williams,JR,2018-19,G,Howard,MEAC,33,1027,209,469,149,308,60,161,112,131,22,68,90,23,22,9,49,55,590
1067,Keena Young,SR,2006-07,F,Brigham Young,MWC,34,984,236,435,236,435,0,0,118,147,79,144,223,50,15,5,75,81,590
1068,Ky Bowman,JR,2018-19,G,Boston College,ACC,31,1220,196,485,117,274,79,211,118,155,26,207,233,125,43,18,90,82,589
1069,Ronnie Brewer,JR,2005-06,G,Arkansas,SEC,32,1112,197,447,146,296,51,151,144,192,39,115,154,104,83,15,70,46,589
1070,Robert Covington,JR,2011-12,F,Tennessee State,OVC,33,1028,212,403,147,258,65,145,100,129,95,165,260,43,51,45,77,97,589
1071,Ethan Happ,SR,2018-19,F,Wisconsin,Big Ten,34,1088,257,485,257,480,0,5,75,161,77,265,342,153,38,44,104,87,589
1072,Ben McLemore,FR,2012-13,G,Kansas,Big 12,37,1191,198,400,125,226,73,174,120,138,47,145,192,73,37,25,77,69,589
1073,Elijah Minnie,JR,2017-18,F,Eastern Michigan,MAC,35,1098,210,464,132,233,78,231,91,108,49,165,214,39,63,66,81,68,589
1074,Johnathan Motley,JR,2016-17,F,Baylor,Big 12,34,1036,226,434,217,401,9,33,128,183,126,209,335,79,12,37,100,104,589
1075,Rian Pearson,SO,2011-12,G,Toledo,MAC,36,1161,231,486,223,455,8,31,119,175,106,194,300,70,56,13,93,84,589
1076,QJ Peterson,SR,2016-17,G,Virginia Military Institute,Southern,30,951,200,464,122,252,78,212,111,156,51,143,194,73,47,2,77,61,589
1077,LaMarcus Reed,SR,2011-12,F,Texas-Arlington,Southland,33,1009,179,388,115,222,64,166,167,209,22,101,123,55,33,12,87,63,589
1078,Rashawn Rembert,JR,2013-14,G,East Tennessee State,A-Sun,35,1262,182,405,74,151,108,254,117,139,29,78,107,61,43,12,54,49,589
1079,Victor Sanders,SR,2017-18,G,Idaho,Big Sky,31,953,182,398,101,189,81,209,144,185,18,89,107,102,32,15,97,78,589
1080,Derrick Walton,SR,2016-17,G,Michigan,Big Ten,38,1323,171,392,73,160,98,232,149,170,17,165,182,189,43,1,66,65,589
1081,Milan Acquaah,SO,2018-19,G,California Baptist,WAC,31,995,191,460,115,257,76,203,130,153,21,135,156,104,50,4,102,82,588
1082,Brian Beard Jr.,SR,2018-19,G,Florida International,CUSA,34,1088,185,469,131,282,54,187,164,230,21,92,113,203,100,2,118,73,588
1083,Kenny Boynton,JR,2011-12,G,Florida,SEC,37,1169,187,425,77,155,110,270,104,138,20,77,97,100,28,1,52,39,588
1084,Joevan Catron,SR,2010-11,F,Oregon,Pac-10,37,1023,195,416,175,347,20,69,178,248,88,159,247,56,42,12,88,95,588
1085,Jon Davis,SO,2016-17,G,Charlotte,CUSA,30,1056,196,407,147,278,49,129,147,188,9,94,103,126,33,8,94,48,588
1086,Devan Downey,SO,2007-08,G,South Carolina,SEC,32,1197,218,515,165,364,53,151,99,135,20,83,103,172,103,6,87,65,588
1087,Tyler Hooker,JR,2018-19,G,Kennesaw State,A-Sun,31,1123,200,509,165,384,35,125,153,184,24,123,147,92,47,7,88,69,588
1088,Daniel Mullings,JR,2013-14,G,New Mexico State,WAC,35,1173,201,431,183,366,18,65,168,231,50,123,173,123,65,16,90,87,588
1089,Kevin Olekaibe,SO,2011-12,G,Fresno State,WAC,33,1205,189,508,97,236,92,272,118,148,21,84,105,39,44,4,50,61,588
1090,J.R. Reynolds,SR,2006-07,G,Virginia,ACC,32,1031,181,422,119,254,62,168,164,197,32,96,128,117,28,3,97,86,588
1091,Sam Sessoms,FR,2018-19,G,Binghamton,AEC,33,1132,224,500,154,309,70,191,70,106,24,85,109,115,37,2,142,71,588
1092,Trey Sumler,JR,2012-13,G,Western Carolina,Southern,32,1207,197,450,143,301,54,149,140,168,31,113,144,114,61,2,115,70,588
1093,Alando Tucker,JR,2005-06,G,Wisconsin,Big Ten,31,1034,222,490,205,422,17,68,127,233,75,102,177,53,19,7,63,40,588
1094,Kwame Vaughn,SR,2012-13,G,Cal State Fullerton,Big West,32,1116,179,399,129,265,50,134,180,215,22,126,148,119,49,7,98,84,588
1095,Justin Black,SR,2013-14,G,Morgan State,MEAC,31,1052,200,442,148,265,52,177,135,225,54,105,159,87,56,2,98,91,587
1096,David Collins,SO,2018-19,G,South Florida,AAC,37,1243,167,418,120,268,47,150,206,293,23,116,139,115,76,11,117,117,587
1097,James Daniel,FR,2013-14,G,Howard,MEAC,28,891,155,421,64,190,91,231,186,233,15,54,69,44,37,1,93,64,587
1098,Shy Ely,SR,2008-09,F,Evansville,MVC,31,1087,204,444,191,395,13,49,166,216,33,147,180,53,24,9,66,64,587
1099,Tyler Hansbrough,FR,2005-06,F,North Carolina,ACC,31,943,199,349,197,345,2,4,187,253,111,132,243,40,38,23,77,88,587
1102,Cory Higgins,JR,2009-10,G,Colorado,Big 12,31,1036,193,382,161,292,32,90,169,203,20,100,120,73,60,11,72,77,587
1103,Reggie Holmes,JR,2008-09,G,Morgan State,MEAC,35,1094,178,479,79,211,99,268,132,178,67,126,193,19,43,11,47,90,587
1104,Tramaine Isabell,JR,2017-18,G,Drexel,CAA,28,963,202,426,152,279,50,147,133,174,30,180,210,96,34,0,80,52,587
1105,ShawnDre' Jones,SR,2016-17,G,Richmond,A-10,35,1269,198,428,129,252,69,176,122,149,12,61,73,136,32,1,68,76,587
1106,Zach Lofton,JR,2016-17,G,Texas Southern,SWAC,35,1140,185,440,152,312,33,128,184,234,30,105,135,86,47,10,81,99,587
1107,Daryl Macon,SR,2017-18,G,Arkansas,SEC,35,1082,174,389,89,187,85,202,154,176,13,88,101,138,36,2,63,62,587
1108,Jalen Riley,SR,2014-15,G,East Tennessee State,Southern,29,798,165,426,85,212,80,214,177,214,12,54,66,77,49,2,82,95,587
1109,B.J. Stith,SR,2018-19,G,Old Dominion,CUSA,35,1206,207,505,134,307,73,198,100,118,50,213,263,36,32,9,62,64,587
1110,Isaiah Thomas,JR,2010-11,G,Washington,Pac-10,35,1115,188,422,128,250,60,172,151,210,26,97,123,213,47,2,104,75,587
1111,Marc Trasolini,SR,2012-13,F,Santa Clara,WCC,38,1173,230,418,216,377,14,41,113,156,100,182,282,34,32,54,64,87,587
1112,Isiah Umipig,JR,2013-14,G,Seattle,WAC,30,993,185,475,79,188,106,287,111,134,19,63,82,107,32,1,98,78,587
1113,C.J. Wilcox,SR,2013-14,G,Washington,Pac-12,32,1116,197,435,107,205,90,230,103,118,22,97,119,81,32,32,54,75,587
1114,Frank Bartley,SR,2017-18,G,Louisiana,Sun Belt,33,1014,179,413,92,186,87,227,141,164,21,97,118,65,45,3,63,65,586
1115,T.J. Cline,JR,2015-16,F,Richmond,A-10,32,961,227,407,183,288,44,119,88,137,38,129,167,122,21,3,72,87,586
1116,Guillermo Diaz,JR,2005-06,G,Miami (FL),ACC,34,1196,194,467,116,253,78,214,120,152,17,83,100,97,39,7,67,59,586
1117,Jerome Dyson,SR,2009-10,G,Connecticut,Big East,34,1143,195,499,155,362,40,137,156,218,33,113,146,144,44,21,132,95,586
1118,Kyle Guy,JR,2018-19,G,Virginia,ACC,38,1345,198,441,78,159,120,282,70,84,27,144,171,78,26,2,53,39,586
1119,Gary Harris,SO,2013-14,G,Michigan State,Big Ten,35,1131,195,455,114,225,81,230,115,142,37,103,140,94,63,15,60,73,586
1120,Corey Hawkins,SR,2014-15,G,UC-Davis,Big West,28,934,188,374,107,208,81,166,129,157,19,119,138,94,39,6,84,53,586
1121,Ray Lee,SO,2014-15,G,Eastern Michigan,MAC,35,981,190,429,120,235,70,194,136,171,25,42,67,54,50,7,101,78,586
1124,LeRoy Nobles,SR,2010-11,G,IUPUI,Summit,32,1144,180,380,115,205,65,175,161,196,41,87,128,41,27,2,66,64,586
1125,Ronshad Shabazz,SR,2018-19,G,Appalachian State,Sun Belt,32,1030,203,460,124,250,79,210,101,124,19,86,105,75,25,2,72,49,586
1126,Lew Stallworth,SR,2018-19,G,Citadel,Southern,29,968,221,419,185,323,36,96,108,146,11,143,154,181,30,1,104,80,586
1127,Shannon Brown,JR,2005-06,G,Michigan State,Big Ten,34,1196,202,433,138,269,64,164,117,141,38,112,150,93,50,5,85,78,585
1128,Jeremy Chappell,SR,2008-09,G,Robert Morris,NEC,35,1143,213,453,129,241,84,212,75,89,53,168,221,112,86,22,101,82,585
1129,Nick Emery,FR,2015-16,G,Brigham Young,WCC,36,1132,203,478,106,225,97,253,82,96,18,108,126,91,52,4,53,100,585
1130,Nate Funk,SR,2006-07,G,Creighton,MVC,33,1138,202,423,147,272,55,151,126,146,25,90,115,99,41,3,71,48,585
1131,Ramon Galloway,SR,2012-13,G,La Salle,A-10,34,1133,193,461,99,233,94,228,105,127,25,132,157,127,65,17,107,81,585
1132,Juan'ya Green,FR,2011-12,G,Niagara,MAAC,33,1229,188,465,127,285,61,180,148,185,24,82,106,147,63,11,115,75,585
1133,Erik McCree,SR,2016-17,F,Louisiana Tech,CUSA,33,1046,202,424,148,275,54,149,127,165,53,242,295,44,15,15,84,53,585
1134,Casper Ware,JR,2010-11,G,Long Beach State,Big West,34,1187,172,408,97,211,75,197,166,205,16,68,84,150,56,6,102,88,585
1135,Billy Baron,JR,2012-13,G,Canisius,MAAC,34,1183,189,431,123,258,66,173,140,170,22,119,141,171,35,0,95,45,584
1136,Kevin Bell,SR,2007-08,G,Fresno State,WAC,32,1199,202,460,170,378,32,82,148,212,13,91,104,187,39,2,106,58,584
1137,Jaron Blossomgame,SR,2016-17,F,Clemson,ACC,33,1133,220,441,196,347,24,94,120,168,59,148,207,51,27,30,56,53,584
1138,Markel Brown,SR,2013-14,G,Oklahoma State,Big 12,34,1201,190,402,135,257,55,145,149,194,36,143,179,99,34,35,55,86,584
1139,Hayden Dalton,SR,2017-18,F,Wyoming,MWC,33,1098,190,415,105,204,85,211,119,142,46,213,259,86,31,16,82,90,584
1140,Jamont Gordon,JR,2007-08,G,Mississippi State,SEC,34,1178,193,465,133,277,60,188,138,199,40,184,224,168,38,21,138,88,584
1141,Juwan Howard,JR,2013-14,F,Detroit Mercy,Horizon,32,1105,216,515,163,361,53,154,99,118,57,113,170,71,31,15,62,75,584
1142,Quin Humphrey,SR,2006-07,G,Youngstown State,Horizon,31,1105,189,437,124,265,65,172,141,182,47,174,221,92,42,10,85,46,584
1143,Darius Johnson-Odom,JR,2010-11,G,Marquette,Big East,37,1109,196,453,125,258,71,195,121,171,18,94,112,88,31,7,75,92,584
1146,Nick Perkins,JR,2017-18,F,Buffalo,MAC,36,990,211,445,175,332,36,113,126,172,80,137,217,28,11,23,72,85,584
1147,Ahmaad Rorie,JR,2017-18,G,Montana,Big Sky,34,1218,206,488,147,314,59,174,113,133,32,101,133,125,42,5,67,64,584
1148,Jeff Teague,SO,2008-09,G,Wake Forest,ACC,31,991,180,371,135,269,45,102,179,219,15,87,102,110,58,20,104,68,584
1149,Alec Wintering,JR,2015-16,G,Portland,WCC,32,1010,182,410,139,302,43,108,177,227,18,88,106,158,49,1,102,87,584
1150,Tristan Blackwood,JR,2006-07,G,Central Connecticut State,NEC,34,1243,182,464,60,150,122,314,97,105,29,56,85,140,42,1,105,65,583
1151,Chase Budinger,SO,2007-08,F,Arizona,Pac-10,34,1200,204,457,131,265,73,192,102,142,34,150,184,99,38,6,80,66,583
1152,E.J. Crawford,JR,2018-19,G,Iona,MAAC,33,1176,205,407,152,267,53,140,120,147,37,130,167,61,23,7,61,72,583
1153,Robert Franks,SR,2018-19,F,Washington State,Pac-12,27,930,201,408,126,220,75,188,106,125,37,158,195,70,18,19,87,68,583
1154,Fred Sims Jr.,SO,2016-17,G,Chicago State,WAC,31,1069,210,582,139,356,71,226,92,114,22,122,144,45,32,9,69,51,583
1155,Curtis Stinson,JR,2005-06,G,Iowa State,Big 12,30,1069,224,492,182,368,42,124,93,140,58,97,155,166,73,0,103,87,583
1156,Tyler Zeller,JR,2010-11,F,North Carolina,ACC,37,1041,211,384,211,384,0,0,161,212,107,161,268,23,27,45,50,100,583
1157,Jamel Artis,SR,2016-17,F,Pittsburgh,ACC,32,1097,196,413,122,224,74,189,116,158,40,116,156,106,13,9,83,61,582
1158,Miles Bridges,SO,2017-18,G,Michigan State,Big Ten,34,1067,209,457,138,262,71,195,93,109,43,194,237,92,21,26,67,53,582
1159,Elijah Brown,JR,2016-17,G,New Mexico,MWC,31,1000,166,438,98,232,68,206,182,220,13,148,161,95,41,4,95,63,582
1160,Jimmy Butler,SR,2010-11,G,Marquette,Big East,37,1282,187,382,167,324,20,58,188,240,90,135,225,86,53,13,54,49,582
1161,Noah Dahlman,JR,2009-10,F,Wofford,Southern,35,1011,224,387,224,386,0,1,134,191,115,104,219,24,30,15,38,70,582
1162,Johnny Dee,JR,2013-14,G,San Diego,WCC,35,1136,184,425,90,200,94,225,120,127,9,88,97,49,38,0,47,57,582
1163,Darnell Edge,SR,2018-19,G,Fairleigh Dickinson,NEC,35,1295,190,402,98,209,92,193,110,123,14,109,123,85,46,1,69,68,582
1164,Gary Flowers,SR,2010-11,F,Southern Mississippi,CUSA,31,965,219,460,169,337,50,123,94,130,78,162,240,33,33,44,76,83,582
1165,Tra Holder,SR,2017-18,G,Arizona State,Pac-12,32,1124,177,435,108,248,69,187,159,190,30,104,134,110,42,1,78,64,582
1168,Kimbal MacKenzie,SR,2018-19,G,Bucknell,Patriot,33,1133,178,419,95,198,83,221,143,167,24,68,92,100,25,1,58,56,582
1169,Jaylen Nowell,SO,2018-19,G,Washington,Pac-12,36,1240,218,434,167,318,51,116,95,122,35,155,190,112,46,9,106,81,582
1170,Wesley Person,SR,2017-18,G,Troy,Sun Belt,33,1123,174,416,77,160,97,256,137,167,21,75,96,59,24,1,61,63,582
1171,Augustine Rubit,JR,2012-13,F,South Alabama,Sun Belt,30,995,192,400,192,395,0,5,198,249,132,183,315,34,21,36,74,63,582
1172,Manny Ubilla,SR,2007-08,G,Fairleigh Dickinson,NEC,28,1074,178,409,85,192,93,217,133,163,17,118,135,136,41,9,105,62,582
1173,Nikola Vucevic,JR,2010-11,F,Southern California,Pac-10,34,1187,215,426,186,343,29,83,123,163,97,253,350,54,18,47,58,96,582
1174,Jaylin Walker,SR,2018-19,G,Kent State,MAC,27,971,181,468,88,225,93,243,127,158,46,107,153,57,36,3,72,35,582
1175,Giordan Watson,JR,2006-07,G,Central Michigan,MAC,31,1071,186,455,122,289,64,166,146,177,18,77,95,129,51,6,118,76,582
1176,Rashad Whack,SR,2013-14,G,Mount St. Mary's,NEC,33,1098,182,437,99,210,83,227,135,171,30,113,143,43,54,13,70,77,582
1177,Denzel Bowles,JR,2010-11,F,James Madison,CAA,33,1061,226,389,226,389,0,0,129,181,83,207,290,71,20,53,110,87,581
1178,Evan Bradds,SR,2016-17,F,Belmont,OVC,29,925,233,374,229,365,4,9,111,148,56,189,245,68,13,6,83,74,581
1179,Ahmad Caver,SR,2018-19,G,Old Dominion,CUSA,35,1316,196,514,126,283,70,231,119,172,18,132,150,193,50,9,76,69,581
1180,C.J. Fair,JR,2012-13,F,Syracuse,Big East,40,1394,217,462,187,398,30,64,117,155,83,192,275,29,44,42,63,63,581
1181,Daniel Horton,SR,2005-06,G,Michigan,Big Ten,33,1126,187,418,116,238,71,180,136,151,10,74,84,174,64,11,115,75,581
1182,Ty Lawson,JR,2008-09,G,North Carolina,ACC,35,1048,182,342,131,234,51,108,166,208,23,81,104,230,75,5,66,59,581
1183,Tanner Leissner,SR,2017-18,F,New Hampshire,AEC,31,1111,195,432,157,317,38,115,153,199,81,133,214,62,15,10,50,65,581
1184,Brynton Lemar,SR,2016-17,G,UC-Davis,Big West,36,1189,179,432,99,224,80,208,143,185,22,98,120,95,28,4,64,74,581
1185,Doug McDermott,FR,2010-11,F,Creighton,MVC,39,1133,220,419,173,303,47,116,94,126,82,198,280,45,11,4,87,81,581
1186,Kyle Randall,SR,2012-13,G,Central Michigan,MAC,31,1068,175,414,109,246,66,168,165,193,23,86,109,79,25,1,89,42,581
1187,Ryan Rossiter,SR,2010-11,F,Siena,MAAC,31,1158,206,440,203,420,3,20,166,211,121,287,408,47,27,42,72,79,581
1188,Jeffery Taylor,SR,2011-12,F,Vanderbilt,SEC,36,1157,210,426,144,270,66,156,95,157,77,123,200,62,46,16,79,67,581
1189,A.J. Abrams,SR,2008-09,G,Texas,Big 12,35,1319,193,484,88,219,105,265,89,105,14,64,78,46,47,4,48,69,580
1190,Jaron Blossomgame,JR,2015-16,F,Clemson,ACC,31,1060,201,392,156,291,45,101,133,170,55,152,207,47,23,41,55,63,580
1191,Demetrius Dyson,JR,2016-17,G,Samford,Southern,36,1110,195,394,109,207,86,187,104,143,36,136,172,40,24,6,79,85,580
1192,Juan'ya Green,JR,2014-15,G,Hofstra,CAA,34,1238,158,414,97,232,61,182,203,246,18,128,146,220,48,9,86,73,580
1193,Jahmal McMurray,SR,2018-19,G,Southern Methodist,AAC,32,1046,206,459,105,203,101,256,67,81,5,70,75,84,23,4,55,69,580
1194,Retin Obasohan,SR,2015-16,G,Alabama,SEC,33,1067,193,410,145,281,48,129,146,209,19,107,126,87,45,10,82,83,580
1195,Tyrese Rice,SO,2006-07,G,Boston College,ACC,33,1208,185,404,126,221,59,183,151,190,30,83,113,178,40,10,110,56,580
1196,Adrian Rodgers,SR,2015-16,G,Southern,SWAC,35,1131,201,492,121,274,80,218,98,124,35,153,188,47,37,4,58,62,580
1197,Dennis Smith Jr.,FR,2016-17,G,North Carolina State,ACC,32,1114,191,420,136,267,55,153,143,200,26,120,146,197,62,14,108,67,580
1198,D'Vauntes Smith-Rivera,SO,2013-14,G,Georgetown,Big East,33,1172,178,400,112,232,66,168,158,181,43,121,164,90,41,5,57,64,580
1199,Justin Wright-Foreman,SO,2016-17,G,Hofstra,CAA,32,905,208,422,141,242,67,180,97,127,21,93,114,52,24,2,45,59,580
1200,Kenny Adeleke,SR,2005-06,F,Hartford,AEC,28,981,223,377,223,377,0,0,133,224,150,216,366,17,29,48,103,84,579
1201,Mike Brown,SR,2015-16,G,Western Carolina,Southern,34,1167,188,466,144,328,44,138,159,198,75,125,200,110,52,12,108,114,579
1202,Tyler Brown,SR,2012-13,G,Illinois State,MVC,32,946,181,411,101,206,80,205,137,170,26,116,142,86,46,7,94,52,579
1203,Frank Eaves,SR,2015-16,G,Appalachian State,Sun Belt,31,965,170,446,87,230,83,216,156,191,20,96,116,68,26,1,70,71,579
1204,Markelle Fultz,FR,2016-17,G,Washington,Pac-12,25,892,209,439,157,313,52,126,109,168,33,110,143,148,40,30,80,63,579
1205,Jessie Govan,SR,2018-19,C,Georgetown,Big East,33,1001,212,427,165,313,47,114,108,141,58,188,246,41,27,41,49,86,579
1206,Randall Gulina,SR,2006-07,G,Samford,OVC,32,1067,184,400,104,186,80,214,131,164,30,78,108,37,27,1,51,61,579
1207,De'Andre Hunter,SO,2018-19,G,Virginia,ACC,38,1234,205,394,159,289,46,105,123,157,52,141,193,75,22,22,52,76,579
1210,Justin Moss ,JR,2014-15,F,Buffalo,MAC,33,991,203,390,203,386,0,4,173,237,91,211,302,21,32,25,73,98,579
1211,Terran Petteway,JR,2013-14,G,Nebraska,Big Ten,32,1014,182,427,134,280,48,147,167,204,29,126,155,52,29,24,88,102,579
1212,Shawn Prudhomme,SR,2016-17,F,Southern,SWAC,33,1103,212,482,137,276,75,206,80,112,45,149,194,44,35,33,65,88,579
1213,Kendrick Ray,JR,2015-16,G,Kennesaw State,A-Sun,31,1059,214,441,173,327,41,114,110,154,44,130,174,85,44,7,76,95,579
1214,Thomas Sanders,SR,2007-08,F,Gardner-Webb,A-Sun,32,1039,211,443,203,405,8,38,149,235,104,242,346,104,43,6,112,99,579
1215,Jordan Sibert,SR,2014-15,G,Dayton,A-10,36,1215,177,388,97,159,80,229,145,184,8,110,118,71,62,5,65,73,579
1216,Xavier Silas,SR,2010-11,G,Northern Illinois,MAC,26,831,178,388,126,262,52,126,171,201,21,98,119,48,31,7,103,70,579
1217,Kyle Allman,SR,2018-19,G,Cal State Fullerton,Big West,33,1162,187,452,127,280,60,172,144,192,10,90,100,65,24,13,81,66,578
1218,Harrison Barnes,FR,2010-11,F,North Carolina,ACC,37,1087,209,497,142,302,67,195,93,124,75,141,216,53,27,16,72,72,578
1219,Yonel Brown,SR,2015-16,G,Kennesaw State,A-Sun,31,1203,198,478,119,261,79,217,103,130,22,83,105,76,35,0,79,61,578
1220,Semaj Christon,SO,2013-14,G,Xavier,Big East,34,1200,201,420,182,371,19,49,157,235,15,76,91,142,45,8,89,72,578
1221,Paul Davis,SR,2005-06,C,Michigan State,Big Ten,33,1018,206,364,200,345,6,19,160,184,87,214,301,54,34,29,81,103,578
1222,Tyler Hall,FR,2015-16,G,Montana State,Big Sky,31,993,202,442,106,219,96,223,78,90,26,137,163,51,28,8,56,68,578
1223,Kyle Hines,SO,2005-06,F,North Carolina-Greensboro,Southern,30,1019,239,384,237,373,2,11,98,178,92,155,247,57,51,84,96,72,578
1224,Stefon Jackson,SO,2006-07,G,Texas-El Paso,CUSA,31,993,194,422,163,325,31,97,159,219,78,119,197,47,47,4,69,87,578
1225,Zach Jackson,SR,2018-19,G,Omaha,Summit,32,1093,204,412,144,273,60,139,110,145,30,109,139,61,26,4,51,58,578
1226,Garrison Johnson,SR,2009-10,G,Jackson State,SWAC,32,1077,172,465,99,257,73,208,161,220,48,97,145,47,33,17,69,61,578
1227,Reggie Johnson,SR,2015-16,G,Hampton,MEAC,32,1153,192,519,138,334,54,185,140,194,39,77,116,129,53,3,90,96,578
1228,Damion Lee,JR,2014-15,G,Drexel,CAA,27,1029,170,388,105,219,65,169,173,195,24,141,165,63,41,9,50,60,578
1229,Kalin Lucas,SR,2010-11,G,Michigan State,Big Ten,34,1136,194,453,141,317,53,136,137,167,16,57,73,114,35,2,87,72,578
1232,Damon Lynn,SO,2014-15,G,NJIT,Ind,33,1203,182,499,56,149,126,350,88,114,15,83,98,123,58,2,92,67,578
1233,A.J. Ogilvy,FR,2007-08,C,Vanderbilt,SEC,34,896,201,342,201,340,0,2,176,229,70,159,229,40,23,49,85,104,578
1234,Scottie Reynolds,JR,2008-09,G,Villanova,Big East,38,1223,168,420,93,205,75,215,167,205,20,89,109,128,59,4,100,88,578
1235,Tracy Smith,JR,2009-10,F,North Carolina State,ACC,35,1122,222,424,222,424,0,0,134,205,84,172,256,40,40,35,65,96,578
1236,Tyler Stone,SR,2013-14,F,Southeast Missouri State,OVC,30,1005,223,410,200,342,23,68,109,153,73,211,284,58,29,46,51,83,578
1237,Sean Armand,SR,2013-14,G,Iona,MAAC,33,1184,190,391,94,174,96,217,101,128,28,78,106,135,39,9,80,93,577
1238,Michael Bryson,SR,2015-16,G,UC-Santa Barbara,Big West,32,1080,202,422,130,234,72,188,101,123,51,154,205,78,26,19,81,75,577
1239,Derrick Byars,SR,2006-07,G,Vanderbilt,SEC,34,1068,206,451,127,239,79,212,86,121,52,113,165,116,48,4,80,81,577
1240,Devin Gibson,SR,2010-11,G,Texas-San Antonio,Southland,34,1190,159,376,132,287,27,89,232,297,46,132,178,183,91,5,113,86,577
1241,D'Angelo Harrison,SR,2014-15,G,St. John's (NY),Big East,33,1150,178,429,112,250,66,179,155,194,38,143,181,64,37,14,55,114,577
1242,Martez Harrison,SO,2014-15,G,Missouri-Kansas City,WAC,33,1057,176,448,129,280,47,168,178,238,19,60,79,129,60,0,86,89,577
1243,Wes Johnson,JR,2009-10,F,Syracuse,Big East,35,1224,207,412,156,289,51,123,112,145,75,224,299,78,58,64,81,72,577
1244,Sean Kilpatrick,JR,2012-13,G,Cincinnati,Big East,34,1169,194,488,112,221,82,267,107,145,45,131,176,63,42,8,67,42,577
1245,Jordan Nwora,SO,2018-19,F,Louisville,ACC,34,1084,198,444,121,238,77,206,104,136,40,220,260,44,32,12,80,70,577
1246,Rodney Pryor,SR,2016-17,G,Georgetown,Big East,32,1044,212,442,128,238,84,204,69,94,33,127,160,41,25,22,55,73,577
1247,Kevin Punter,SR,2015-16,G,Tennessee,SEC,26,886,177,385,119,228,58,157,165,202,5,84,89,91,36,6,66,73,577
1248,Matt Rafferty,SR,2018-19,F,Furman,Southern,33,1101,217,353,209,328,8,25,135,176,87,211,298,141,84,36,68,71,577
1249,Dyami Starks,SR,2014-15,G,Bryant,NEC,31,1183,187,496,89,210,98,286,105,115,16,89,105,47,27,7,66,60,577
1250,Edwin Ubiles,SO,2007-08,F,Siena,MAAC,34,1130,231,439,197,358,34,81,81,115,47,101,148,57,41,33,55,48,577
1251,Isiah Umipig,SR,2014-15,G,Seattle,WAC,34,1155,178,440,55,146,123,294,98,116,12,95,107,98,45,0,73,73,577
1254,Greivis Vasquez,SO,2007-08,G,Maryland,ACC,34,1258,199,461,135,254,64,207,115,147,31,162,193,231,47,9,149,78,577
1255,Thomas Wilder,SO,2015-16,G,Western Michigan,MAC,32,1018,172,405,127,290,45,115,188,238,21,113,134,98,52,4,66,85,577
1256,Jeffrey Carroll,JR,2016-17,G,Oklahoma State,Big 12,33,960,198,369,139,236,59,133,121,150,64,153,217,40,29,5,52,64,576
1257,Daniel Dixon,SR,2016-17,G,William & Mary,CAA,30,884,188,390,115,197,73,193,127,146,26,115,141,75,22,9,67,83,576
1258,Keith Gabriel,SR,2011-12,G,Virginia Military Institute,Big South,33,944,192,448,117,214,75,234,117,157,27,88,115,62,59,41,73,75,576
1259,D'Angelo Harrison,JR,2013-14,G,St. John's (NY),Big East,33,1086,169,443,105,270,64,173,174,202,29,132,161,62,32,16,48,83,576
1260,Juwan Howard,SR,2014-15,F,Detroit Mercy,Horizon,33,1042,208,479,144,322,64,157,96,113,35,100,135,78,31,10,69,67,576
1261,Kevin Knox,FR,2017-18,F,Kentucky,SEC,37,1198,196,440,139,273,57,167,127,164,33,167,200,53,31,10,85,82,576
1262,Jock Landale,JR,2016-17,C,Saint Mary's (CA),WCC,34,962,229,375,225,357,4,18,114,158,103,219,322,58,10,41,72,87,576
1263,Lauri Markkanen,FR,2016-17,F,Arizona,Pac-12,37,1140,185,376,116,213,69,163,137,164,88,178,266,32,15,19,40,73,576
1264,Marquise Moore,SR,2016-17,G,George Mason,A-10,34,1188,202,418,192,385,10,33,162,231,58,311,369,119,32,26,95,69,576
1265,Anthony Odunsi,SR,2015-16,G,Houston Baptist,Southland,33,950,154,324,141,285,13,39,255,304,26,125,151,122,40,1,116,69,576
1266,Jalen Ross,SR,2016-17,G,Hartford,AEC,29,1003,173,452,104,260,69,192,161,195,8,92,100,61,37,1,84,41,576
1267,Keith Simmons,SR,2006-07,G,Holy Cross,Patriot,34,1209,190,382,139,236,51,146,145,189,79,117,196,63,77,23,62,77,576
1268,Ryan Thompson,JR,2008-09,G,Rider,MAAC,32,1224,197,387,151,278,46,109,136,176,67,142,209,103,56,12,85,68,576
1269,Anthony Winchester,SR,2005-06,G,Western Kentucky,Sun Belt,31,971,201,425,120,227,81,198,93,122,65,110,175,78,30,7,84,63,576
1270,Joe Young,SO,2012-13,G,Houston,CUSA,32,1048,185,404,119,247,66,157,140,160,18,94,112,79,19,0,41,40,576
1271,Kendall Anthony,SR,2014-15,G,Richmond,A-10,35,1276,203,455,143,302,60,153,109,138,10,53,63,89,33,1,54,74,575
1272,Keion Bell,SO,2009-10,G,Pepperdine,WCC,31,977,194,454,154,342,40,112,147,196,40,119,159,98,41,9,121,45,575
1273,Ryan Bowie,SR,2015-16,G,Texas-San Antonio,CUSA,32,1107,188,425,107,224,81,201,118,152,51,161,212,50,27,7,71,88,575
1276,Jackie Carmichael,SR,2012-13,F,Illinois State,MVC,33,1009,213,404,211,393,2,11,147,216,83,223,306,28,32,68,77,84,575
1277,DeMarcus Cousins,FR,2009-10,F,Kentucky,SEC,38,893,206,369,205,363,1,6,162,268,154,220,374,38,37,67,78,122,575
1278,Markeith Cummings,FR,2009-10,F,Kennesaw State,A-Sun,33,1123,204,448,171,350,33,98,134,187,79,122,201,70,31,6,95,80,575
1279,Will Daniels,JR,2006-07,F,Rhode Island,A-10,33,933,180,367,129,245,51,122,164,215,54,132,186,51,27,19,79,89,575
1280,David Gonzalvez,JR,2008-09,G,Richmond,A-10,36,1280,206,433,134,259,72,174,91,129,37,135,172,72,40,14,58,91,575
1281,Paul Graham,SR,2008-09,G,Florida Atlantic,Sun Belt,31,1071,196,503,130,306,66,197,117,141,26,94,120,62,20,3,64,55,575
1282,Jon Axel Gudmundsson,JR,2018-19,G,Davidson,A-10,34,1252,177,385,117,215,60,170,161,195,25,223,248,164,45,3,84,51,575
1283,Walt Lemon ,SR,2013-14,G,Bradley,MVC,32,1135,210,495,181,395,29,100,126,169,8,90,98,124,78,3,115,76,575
1284,Nick Mayo,SO,2016-17,F,Eastern Kentucky,OVC,31,1092,203,403,171,321,32,82,137,177,45,156,201,88,27,42,93,77,575
1285,E'Twaun Moore,JR,2009-10,G,Purdue,Big Ten,35,1103,212,476,161,330,51,146,100,137,32,102,134,93,51,10,73,79,575
1286,Monte Morris,SR,2016-17,G,Iowa State,Big 12,35,1237,216,465,162,322,54,143,89,111,40,129,169,217,53,10,42,51,575
1287,Devin Patterson,SR,2015-16,G,Omaha,Summit,32,1046,181,424,124,260,57,164,156,194,12,68,80,101,59,0,85,82,575
1288,Mike Scott,SR,2011-12,F,Virginia,ACC,32,999,215,382,209,362,6,20,139,172,70,195,265,37,21,15,67,56,575
1289,Jameel Warney,JR,2014-15,F,Stony Brook,AEC,35,1156,243,452,243,452,0,0,89,155,150,259,409,72,26,87,59,74,575
1290,D.J. White,SR,2007-08,F,Indiana,Big Ten,33,1105,216,357,215,354,1,3,142,206,100,241,341,25,26,54,63,83,575
1291,Talor Battle,JR,2009-10,G,Penn State,Big Ten,31,1146,193,459,122,256,71,203,117,166,19,146,165,129,34,2,72,52,574
1292,Sherwood Brown,SR,2012-13,G,Florida Gulf Coast,A-Sun,37,1225,210,449,137,255,73,194,81,123,58,184,242,45,52,10,67,73,574
1293,Marcus Denmon,JR,2010-11,G,Missouri,Big 12,34,1035,199,398,117,215,82,183,94,124,33,86,119,61,61,4,32,56,574
1294,Trevor Releford,SR,2013-14,G,Alabama,SEC,31,1078,187,377,115,194,72,183,128,151,19,89,108,97,69,3,82,84,574
1295,Terrence Ross,SO,2011-12,G,Washington,Pac-12,35,1088,215,470,143,276,72,194,72,94,48,177,225,49,44,33,70,99,574
1296,Blake Schilb,JR,2005-06,G,Loyola (IL),Horizon,30,1044,192,412,124,232,68,180,122,147,37,119,156,118,38,27,100,56,574
1297,Loren Stokes,JR,2005-06,G,Hofstra,CAA,33,1155,233,474,206,397,27,77,81,136,46,121,167,93,52,14,98,80,574
1298,Luke Babbitt,FR,2008-09,F,Nevada,WAC,34,1110,194,425,161,348,33,77,152,176,63,188,251,47,24,24,65,61,573
1299,Travis Bader,SO,2011-12,G,Oakland,Summit,36,1302,188,441,64,127,124,314,73,94,23,92,115,43,31,4,37,93,573
1300,Julian Boyd,JR,2011-12,F,Long Island University,NEC,33,893,206,370,185,320,21,50,140,190,80,228,308,26,16,21,70,97,573
1301,Garrison Carr,SR,2008-09,G,American,Patriot,32,1153,189,471,75,178,114,293,81,105,16,82,98,52,31,2,84,66,573
1302,J.J. Frazier,JR,2015-16,G,Georgia,SEC,34,1090,169,412,93,215,76,197,159,193,17,137,154,151,49,3,55,92,573
1303,Kavin Gilder-Tilbury,SR,2016-17,F,Texas State,Sun Belt,36,1103,205,415,134,228,71,187,92,140,37,165,202,64,43,35,69,103,573
1304,Antonio Green,JR,2018-19,G,Middle Tennessee,CUSA,32,1131,196,521,91,217,105,304,76,87,11,118,129,51,33,3,101,64,573
1305,Khallid Hart,SR,2016-17,G,Marist,MAAC,32,1135,186,407,122,233,64,174,137,173,11,74,85,73,36,8,50,68,573
1306,Sean Hoehn,SR,2018-19,G,Sacred Heart,NEC,32,1011,182,384,117,224,65,160,144,170,15,90,105,82,48,4,99,84,573
1307,Braxton Huggins,SR,2018-19,G,Fresno State,MWC,31,924,190,447,89,185,101,262,92,116,19,113,132,53,35,10,69,69,573
1308,Robbie Hummel,SR,2011-12,F,Purdue,Big Ten,35,1128,194,465,122,277,72,188,113,137,55,196,251,66,23,42,32,73,573
1309,Nick Kellogg,SR,2013-14,G,Ohio,MAC,37,1206,196,424,109,202,87,222,94,106,22,112,134,109,39,1,55,77,573
1310,Nathan Knight,SO,2017-18,F,William & Mary,CAA,31,890,206,358,195,322,11,36,150,195,58,168,226,69,18,61,83,103,573
1311,Eric Maynor,JR,2007-08,G,Virginia Commonwealth,CAA,32,1115,196,427,146,300,50,127,131,172,24,110,134,175,40,7,96,61,573
1312,Drew McDonald,SO,2016-17,F,Northern Kentucky,Horizon,35,1052,201,425,148,287,53,138,118,160,71,197,268,61,15,19,77,82,573
1313,Jamal Olasewere,JR,2011-12,F,Long Island University,NEC,34,884,197,345,183,304,14,41,165,225,68,187,255,37,51,37,110,120,573
1314,Dan Oppland,SR,2005-06,F,Valparaiso,Mid-Cont,29,985,231,455,196,356,35,99,76,121,86,146,232,55,26,5,54,85,573
1315,Shamorie Ponds,FR,2016-17,G,St. John's (NY),Big East,33,1109,191,435,116,235,75,200,116,141,38,108,146,102,68,8,62,58,573
1318,Michael Qualls,JR,2014-15,G,Arkansas,SEC,36,1086,180,413,125,248,55,165,158,204,59,133,192,60,32,17,61,62,573
1319,Brian Roberts,JR,2006-07,G,Dayton,A-10,31,1103,179,386,97,207,82,179,133,148,6,83,89,82,22,7,72,60,573
1320,Gabe Rogers,SR,2012-13,G,Northern Arizona,Big Sky,32,1115,202,517,107,258,95,259,74,91,12,51,63,58,32,2,88,49,573
1321,Justin Strings,SR,2017-18,F,Sacramento State,Big Sky,32,1157,223,522,193,416,30,106,97,157,46,179,225,75,19,30,73,77,573
1322,Kris Wilkes,SO,2018-19,G,UCLA,Pac-12,33,1047,204,471,135,266,69,205,96,143,39,119,158,56,20,14,63,71,573
1323,Jahmar Young,SO,2008-09,G,New Mexico State,WAC,32,1086,182,398,113,234,69,164,140,170,22,105,127,104,44,7,70,78,573
1324,James Young,FR,2013-14,G,Kentucky,SEC,40,1296,183,450,101,215,82,235,125,177,41,130,171,67,30,8,75,83,573
1325,Grayson Allen,SR,2017-18,G,Duke,ACC,37,1319,181,433,79,157,102,276,108,127,20,103,123,172,64,2,79,79,572
1326,Tookie Brown,SR,2018-19,G,Georgia Southern,Sun Belt,33,1163,198,399,158,281,40,118,136,178,24,116,140,154,44,4,77,71,572
1327,T.T. Carey,SR,2013-14,G,Longwood,Big South,31,1013,206,470,112,232,94,238,66,84,30,174,204,24,46,11,49,73,572
1328,Stephen Croone,SO,2013-14,G,Furman,Southern,30,998,175,374,145,281,30,93,192,256,10,122,132,112,50,8,108,64,572
1329,Chris Denson,SR,2013-14,G,Auburn,SEC,30,961,187,406,165,323,22,83,176,268,37,93,130,71,30,3,54,64,572
1330,Jud Dillard,JR,2011-12,F,Tennessee Tech,OVC,33,1103,198,383,191,350,7,33,169,205,85,197,282,42,34,5,79,65,572
1331,Noah Hartsock,SR,2011-12,F,Brigham Young,WCC,34,1049,216,382,204,347,12,35,128,152,41,130,171,50,29,55,53,69,572
1332,Gordon Hayward,SO,2009-10,F,Butler,Horizon,37,1239,173,373,126,213,47,160,179,216,72,233,305,62,40,30,85,78,572
1333,Josh Jackson,FR,2016-17,G,Kansas,Big 12,35,1077,220,429,186,339,34,90,98,173,81,177,258,104,59,37,97,104,572
1334,Shabazz Muhammad,FR,2012-13,G,UCLA,Pac-12,32,987,202,456,162,350,40,106,128,180,87,80,167,27,23,4,51,53,572
1335,Kyle O'Quinn,SR,2011-12,C,Norfolk State,MEAC,36,1125,205,358,199,326,6,32,156,224,114,258,372,51,25,97,95,117,572
1336,Cameron Payne,FR,2013-14,G,Murray State,OVC,34,1111,190,470,118,259,72,211,120,155,10,113,123,185,57,20,110,96,572
1337,Jared Terrell,SR,2017-18,G,Rhode Island,A-10,34,1128,191,447,116,266,75,181,115,140,32,87,119,80,50,7,59,78,572
1340,D.J. Thompson,JR,2005-06,G,Appalachian State,Southern,30,1038,175,458,77,201,98,257,124,154,35,75,110,132,81,1,89,64,572
1341,Evan Turner,SO,2008-09,G,Ohio State,Big Ten,33,1202,193,384,182,359,11,25,175,222,56,178,234,131,58,27,117,97,572
1342,Ryan Wittman,JR,2008-09,F,Cornell,Ivy,31,1056,197,436,100,203,97,233,81,99,13,98,111,82,27,7,56,67,572
1343,Bradford Burgess,JR,2010-11,G,Virginia Commonwealth,CAA,40,1380,193,396,121,230,72,166,113,150,85,166,251,66,43,30,61,86,571
1344,Joe Cremo,JR,2017-18,G,Albany (NY),AEC,32,1128,182,397,106,231,76,166,131,160,20,112,132,120,27,9,68,70,571
1345,Majok Deng,SR,2015-16,F,Louisiana-Monroe,Sun Belt,31,1126,193,403,134,246,59,157,126,155,51,167,218,60,22,51,68,77,571
1346,Tyler Dorsey,SO,2016-17,G,Oregon,Pac-12,39,1169,189,405,101,197,88,208,105,139,33,102,135,67,30,4,59,57,571
1347,Jared Dudley,SR,2006-07,F,Boston College,ACC,30,1152,195,347,156,259,39,88,142,191,91,157,248,90,42,10,78,66,571
1348,Adam Flagler,FR,2018-19,G,Presbyterian,Big South,36,1105,196,447,88,167,108,280,71,85,27,95,122,45,28,9,42,61,571
1349,Kyle Gibson,SR,2009-10,G,Louisiana Tech,WAC,31,1065,163,411,102,225,61,186,184,219,27,93,120,94,28,2,74,64,571
1350,Justin Greene,JR,2010-11,F,Kent State,MAC,37,1208,222,464,222,463,0,1,127,179,99,209,308,61,39,53,111,105,571
1351,Marshall Henderson,SR,2013-14,G,Mississippi,SEC,30,934,172,487,43,110,129,377,98,120,9,48,57,61,45,2,55,50,571
1352,Otis Livingston II,JR,2017-18,G,George Mason,A-10,33,1198,193,443,128,273,65,170,120,140,7,100,107,144,33,2,86,43,571
1353,Javier Mojica,SR,2006-07,G,Central Connecticut State,NEC,34,1233,204,455,133,280,71,175,92,122,63,178,241,108,52,8,87,82,571
1354,Luke Nevill,SR,2008-09,C,Utah,MWC,34,1084,201,331,201,331,0,0,169,215,68,239,307,44,15,92,82,97,571
1355,Kelly Olynyk,JR,2012-13,F,Gonzaga,WCC,32,845,215,342,206,312,9,30,132,170,77,158,235,55,22,36,77,72,571
1356,Dylan Windler,JR,2017-18,F,Belmont,OVC,33,1168,204,365,135,203,69,162,94,131,57,250,307,90,34,31,78,86,571
1357,Pablo Bertone,SR,2013-14,G,Florida Atlantic,CUSA,30,1014,207,459,155,304,52,155,104,143,20,96,116,64,39,2,84,80,570
1358,Joe Harris ,JR,2012-13,G,Virginia,ACC,35,1139,191,408,114,227,77,181,111,150,30,111,141,76,31,17,70,82,570
1359,TJ Haws,JR,2018-19,G,Brigham Young,WCC,32,1070,174,376,117,214,57,162,165,190,10,102,112,162,38,9,75,69,570
1362,Lazar Hayward,JR,2008-09,F,Marquette,Big East,35,1109,204,435,151,287,53,148,109,133,99,203,302,39,35,9,65,89,570
1363,Sheldon McClellan,SR,2015-16,G,Miami (FL),ACC,35,1151,177,351,121,213,56,138,160,191,19,93,112,56,36,9,44,62,570
1364,Kenard Moore,SR,2008-09,G,Southeast Missouri State,OVC,30,1086,201,483,104,198,97,285,71,91,16,51,67,47,35,4,85,63,570
1365,Sviatoslav Mykhailiuk,SR,2017-18,G,Kansas,Big 12,39,1346,205,472,90,213,115,259,45,56,44,109,153,107,46,12,65,97,570
1366,Alec Peters,SO,2014-15,F,Valparaiso,Horizon,34,1039,195,399,112,221,83,178,97,117,64,163,227,42,24,11,49,67,570
1367,Belton Rivers,SR,2006-07,G,Tennessee Tech,OVC,32,1068,182,457,90,204,92,253,114,153,24,93,117,81,35,2,92,75,570
1368,Markel Starks,SR,2013-14,G,Georgetown,Big East,33,1222,186,451,129,276,57,175,141,162,14,62,76,135,30,3,76,78,570
1369,Jarvis Summers,JR,2013-14,G,Mississippi,SEC,33,1011,190,391,143,280,47,111,143,187,12,67,79,126,31,10,76,93,570
1370,Brandon Tabb,JR,2016-17,G,Bethune-Cookman,MEAC,32,1100,187,493,81,186,106,307,90,109,26,148,174,53,43,19,48,101,570
1371,Jahad Thomas,SR,2017-18,G,Massachusetts-Lowell,AEC,27,979,211,410,195,366,16,44,132,189,69,157,226,107,48,8,95,70,570
1372,Dan Trist,SR,2014-15,F,Lafayette,Patriot,33,892,230,399,230,399,0,0,110,141,76,146,222,43,12,23,75,71,570
1373,Moritz Wagner,JR,2017-18,F,Michigan,Big Ten,39,1078,216,409,153,249,63,160,75,108,57,221,278,33,38,20,56,120,570
1374,C.J. Wilcox,JR,2012-13,G,Washington,Pac-12,34,1184,201,480,126,275,75,205,93,114,40,106,146,65,37,36,63,71,570
1375,Kyle Wilson,SO,2013-14,G,Army,Patriot,31,959,189,427,126,282,63,145,129,163,15,65,80,45,17,3,64,50,570
1376,Jeremy Atkinson,SR,2012-13,F,North Carolina-Asheville,Big South,32,1101,198,411,170,323,28,88,145,179,77,151,228,80,50,4,86,69,569
1377,Torrey Craig,JR,2012-13,F,South Carolina Upstate,A-Sun,33,1022,194,454,116,240,78,214,103,144,62,166,228,63,33,25,88,68,569
1378,Torrey Craig,SR,2013-14,F,South Carolina Upstate,A-Sun,34,1113,204,500,136,267,68,233,93,151,67,170,237,77,31,28,84,84,569
1379,Khallid Hart,JR,2015-16,G,Marist,MAAC,28,1021,164,369,92,181,72,188,169,201,10,64,74,58,42,2,63,65,569
1380,Corey Hawkins,JR,2012-13,G,UC-Davis,Big West,28,951,183,386,135,266,48,120,155,184,24,133,157,93,42,7,72,62,569
1381,TJ Leaf,FR,2016-17,F,UCLA,Pac-12,35,1048,235,381,208,323,27,58,72,106,78,209,287,85,22,39,52,89,569
1384,Dennis Mavin,SR,2014-15,G,Florida International,CUSA,33,1174,198,452,167,353,31,99,142,221,27,147,174,103,41,1,118,47,569
1385,Tasmin Mitchell,JR,2008-09,F,Louisiana State,SEC,35,1137,224,429,214,410,10,19,111,153,92,159,251,68,55,23,70,89,569
1386,Harding Nana,SR,2005-06,F,Delaware,CAA,30,1059,200,426,154,293,46,133,123,192,89,237,326,52,37,38,85,88,569
1387,Roberto Nelson,JR,2012-13,G,Oregon State,Pac-12,32,1000,179,404,123,263,56,141,155,202,36,69,105,77,31,10,73,73,569
1388,Deshon Taylor,JR,2017-18,G,Fresno State,MWC,32,1083,155,353,96,200,59,153,200,240,12,89,101,83,49,5,79,72,569
1389,MaCio Teague,SO,2017-18,G,North Carolina-Asheville,Big South,34,1200,181,433,84,205,97,228,110,127,17,132,149,85,54,4,70,57,569
1390,Jon Brockman,JR,2007-08,F,Washington,Pac-10,32,1009,237,442,237,442,0,0,94,181,141,229,370,35,21,8,76,94,568
1391,A.J. English,SO,2013-14,G,Iona,MAAC,33,1207,170,419,86,182,84,237,144,188,22,108,130,142,33,14,92,80,568
1392,Moses Greenwood,SR,2018-19,F,Southeastern Louisiana,Southland,33,984,223,371,207,331,16,40,106,151,92,156,248,28,31,35,81,114,568
1393,Eron Harris,SO,2013-14,G,West Virginia,Big 12,33,1035,183,418,94,207,89,211,113,132,27,87,114,52,24,7,68,78,568
1394,Richard Hendrix,JR,2007-08,F,Alabama,SEC,32,980,229,383,227,376,2,7,108,201,118,206,324,51,41,62,55,94,568
1395,Tyrone Lewis,JR,2008-09,G,Niagara,MAAC,35,1219,175,519,76,220,99,299,119,149,60,102,162,69,91,28,72,82,568
1396,Derick Newton,SO,2016-17,F,Stetson,A-Sun,32,1012,184,399,123,234,61,165,139,171,42,140,182,41,19,8,57,51,568
1397,James Palmer,JR,2017-18,G,Nebraska,Big Ten,33,1024,181,408,138,269,43,139,163,221,41,103,144,99,32,16,72,61,568
1398,Will Pratt,SR,2010-11,F,Northwestern State,Southland,32,799,193,380,172,312,21,68,161,241,51,91,142,39,42,9,109,113,568
1399,Jordan Price,SO,2014-15,G,La Salle,A-10,33,1054,180,465,111,262,69,203,139,174,16,113,129,75,27,8,103,94,568
1400,Brandon Tabb,SR,2017-18,G,Bethune-Cookman,MEAC,30,938,172,433,75,145,97,288,127,139,23,86,109,49,46,11,68,84,568
1401,Melo Trimble,FR,2014-15,G,Maryland,Big Ten,35,1173,150,338,89,190,61,148,207,240,6,129,135,106,44,2,86,65,568
1402,Tre'Von Willis,JR,2009-10,G,Nevada-Las Vegas,MWC,33,985,182,381,141,242,41,139,163,190,28,102,130,114,41,7,80,84,568
1403,Jared Brownridge,FR,2013-14,G,Santa Clara,WCC,33,1107,183,403,88,185,95,218,106,123,11,74,85,76,24,4,48,64,567
1404,Kyle Collinsworth,SR,2015-16,G,Brigham Young,WCC,37,1249,206,444,197,407,9,37,146,224,86,217,303,275,74,20,126,74,567
1405,Anthony Davis,FR,2011-12,F,Kentucky,SEC,40,1281,210,337,207,317,3,20,144,203,119,296,415,50,54,186,41,78,567
1406,Grant Golden,SO,2018-19,F,Richmond,A-10,33,1035,221,439,205,385,16,54,109,166,26,207,233,117,15,35,82,61,567
1407,Georges Niang,SO,2013-14,F,Iowa State,Big 12,34,1025,222,468,174,321,48,147,75,104,34,118,152,123,21,21,82,109,567
1408,Jahad Thomas,JR,2016-17,G,Massachusetts-Lowell,AEC,31,1051,224,380,222,378,2,2,117,173,71,209,280,143,50,8,117,94,567
1409,Denzel Valentine,JR,2014-15,G,Michigan State,Big Ten,39,1295,197,445,95,200,102,245,71,86,46,199,245,167,35,9,92,85,567
1410,Jamar Wilson,JR,2005-06,G,Albany (NY),AEC,32,1116,171,377,122,242,49,135,176,207,31,127,158,125,43,7,117,88,567
1411,Antoine Agudio,SO,2005-06,G,Hofstra,CAA,33,1212,194,432,103,216,91,216,87,122,23,74,97,90,35,3,92,43,566
1412,Sean Armand,JR,2012-13,G,Iona,MAAC,34,1233,189,434,77,160,112,274,76,99,45,128,173,103,42,16,69,102,566
1413,William Buford,SR,2011-12,G,Ohio State,Big Ten,39,1320,205,489,143,316,62,173,94,114,35,159,194,104,33,9,84,71,566
1414,Jaevin Cumberland,JR,2018-19,G,Oakland,Horizon,33,1222,173,407,64,134,109,273,111,130,14,82,96,114,37,6,60,69,566
1415,Markeith Cummings,SO,2010-11,F,Kennesaw State,A-Sun,31,1102,198,434,186,377,12,57,158,235,63,92,155,56,45,4,90,73,566
1416,Cortez Edwards,JR,2017-18,G,Southern Mississippi,CUSA,34,1219,221,449,196,361,25,88,99,128,70,147,217,98,71,14,62,54,566
1417,Chris Evans,SR,2012-13,F,Kent State,MAC,35,1144,189,396,150,273,39,123,149,204,79,190,269,72,66,24,93,88,566
1418,Jared Jordan,SR,2006-07,G,Marist,MAAC,33,1252,197,464,141,276,56,188,116,168,46,148,194,286,45,2,110,54,566
1419,Jack McClinton,JR,2007-08,G,Miami (FL),ACC,32,1007,179,418,85,198,94,220,114,124,11,66,77,82,24,1,79,58,566
1420,Jacolby Mobley,SR,2016-17,G,Tennessee-Martin,OVC,29,1025,182,432,87,173,95,259,107,137,22,62,84,60,30,3,58,57,566
1421,Julian Norfleet,SR,2013-14,G,Mount St. Mary's,NEC,33,1078,195,431,139,269,56,162,120,162,13,81,94,181,52,9,97,82,566
1422,Dyami Starks,JR,2013-14,G,Bryant,NEC,30,1089,193,465,105,226,88,239,92,107,25,76,101,60,32,1,58,66,566
1423,Pancake Thomas,SR,2015-16,G,Hartford,AEC,30,1038,178,407,97,217,81,190,129,156,30,163,193,84,36,6,53,72,566
1426,Ryan Thompson,SR,2009-10,G,Rider,MAAC,33,1209,172,408,125,263,47,145,175,214,45,119,164,91,38,11,71,65,566
1427,Jerome Tillman,SR,2008-09,F,Ohio,MAC,32,1047,183,361,156,279,27,82,173,235,84,174,258,38,35,16,74,93,566
1428,Damani Applewhite,JR,2018-19,G,South Carolina State,MEAC,34,1155,198,391,194,375,4,16,165,234,81,171,252,37,12,9,54,61,565
1429,George Beamon,SR,2013-14,G,Manhattan,MAAC,30,926,170,417,117,274,53,143,172,208,48,146,194,23,47,10,55,69,565
1430,Joel Bolomboy,SR,2015-16,F,Weber State,Big Sky,33,1041,193,337,173,282,20,55,159,228,109,306,415,35,23,40,78,73,565
1431,Devontae Cacok,JR,2017-18,F,North Carolina-Wilmington,CAA,32,942,221,378,221,378,0,0,123,201,162,269,431,28,33,18,72,124,565
1432,Antwan Carter,JR,2010-11,C,Longwood,Ind,31,1007,237,414,228,377,9,37,82,120,72,221,293,50,28,23,66,106,565
1433,Jawan Carter,JR,2009-10,G,Delaware,CAA,31,1214,160,413,86,186,74,227,171,212,23,79,102,151,40,0,93,83,565
1434,Eric Devendorf,JR,2008-09,G,Syracuse,Big East,36,1220,193,435,111,225,82,210,97,122,14,57,71,108,38,12,107,82,565
1435,Anthony Drmic,SO,2012-13,G,Boise State,MWC,32,1027,185,399,105,195,80,204,115,148,30,117,147,74,20,8,67,96,565
1436,Branden Frazier,SR,2013-14,G,Fordham,A-10,31,1140,186,468,141,309,45,159,148,173,47,110,157,133,34,9,93,72,565
1437,J.R. Holder,SR,2016-17,F,Jacksonville,A-Sun,32,1080,200,389,155,265,45,124,120,167,34,78,112,61,36,15,84,60,565
1438,Jordan Howard,SO,2015-16,G,Central Arkansas,Southland,28,976,175,411,80,189,95,222,120,137,18,76,94,78,18,2,61,33,565
1439,Kareem Jamar,SR,2013-14,G,Montana,Big Sky,30,1086,182,386,137,257,45,129,156,219,25,144,169,121,27,15,67,74,565
1440,"David Jenkins, Jr.",FR,2017-18,G,South Dakota State,Summit,35,1032,183,424,99,204,84,220,115,144,10,103,113,57,13,0,59,68,565
1441,Dana Smith,SR,2009-10,F,Longwood,Ind,31,986,195,408,162,311,33,97,142,214,76,148,224,78,30,16,92,103,565
1442,Marcus Thornton,SO,2012-13,G,William & Mary,CAA,30,1090,181,411,88,197,93,214,110,133,11,72,83,83,26,15,92,44,565
1443,Marquis Weddle,FR,2007-08,G,Tennessee-Martin,OVC,33,1150,199,487,100,193,99,294,68,91,13,81,94,59,29,1,77,38,565
1444,Brandon Wood,SO,2009-10,G,Valparaiso,Horizon,32,1014,198,427,142,277,56,150,113,139,32,113,145,72,33,4,81,69,565
1445,Mark Zoller,SR,2006-07,F,Pennsylvania,Ivy,31,970,206,369,165,260,41,109,112,143,59,173,232,87,55,12,83,107,565
1448,Tim Abromaitis,JR,2009-10,F,Notre Dame,Big East,35,1104,183,370,102,181,81,189,117,134,43,123,166,52,17,11,42,76,564
1449,Armon Bassett,JR,2009-10,G,Ohio,MAC,33,1150,164,421,92,213,72,208,164,202,9,99,108,117,41,2,77,44,564
1450,O'Darien Bassett,SR,2007-08,G,Troy,Sun Belt,31,954,186,452,120,259,66,193,126,154,33,87,120,73,40,3,64,53,564
1451,Anthony Bennett,FR,2012-13,F,Nevada-Las Vegas,MWC,35,950,202,379,166,283,36,96,124,177,86,199,285,34,24,43,65,80,564
1452,Davion Berry,JR,2012-13,G,Weber State,Big Sky,37,1186,179,376,119,231,60,145,146,193,15,139,154,140,45,10,75,67,564
1453,Bennie Boatwright,SR,2018-19,F,Southern California,Pac-12,31,1038,197,416,107,206,90,210,80,114,43,162,205,79,23,18,46,75,564
1454,Evan Bradds,JR,2015-16,G,Belmont,OVC,32,980,210,294,207,287,3,7,141,200,69,226,295,70,10,8,78,91,564
1455,Taylor Braun,SR,2013-14,G,North Dakota State,Summit,32,1088,170,361,129,262,41,99,183,233,20,155,175,120,49,6,63,68,564
1456,Dillon Brooks,JR,2016-17,F,Oregon,Pac-12,35,886,206,422,149,280,57,142,95,126,35,78,113,95,38,16,72,97,564
1457,Jalen Cannon,SR,2014-15,F,St. Francis (NY),NEC,35,1184,210,404,183,323,27,81,117,168,139,228,367,34,24,27,58,60,564
1458,Austin Freeman,SR,2010-11,G,Georgetown,Big East,32,1082,204,429,142,256,62,173,94,108,21,97,118,78,23,5,54,58,564
1459,Zach Johnson,JR,2017-18,G,Florida Gulf Coast,A-Sun,35,1134,203,433,134,257,69,176,89,114,15,100,115,104,70,5,79,72,564
1460,Christian Maraker,SR,2005-06,F,Pacific,Big West,32,1101,205,412,175,322,30,90,124,146,66,219,285,68,27,21,83,72,564
1461,Josh Mayo,JR,2007-08,G,Illinois-Chicago,Horizon,33,1068,174,379,80,179,94,200,122,145,16,68,84,106,40,0,83,58,564
1462,Tywain McKee,JR,2007-08,G,Coppin State,MEAC,34,1203,177,402,114,258,63,144,147,169,49,99,148,106,52,4,88,91,564
1463,Tony Mitchell,SO,2010-11,F,Alabama,SEC,37,1167,228,437,197,339,31,98,77,117,97,164,261,49,59,41,64,89,564
1464,Terran Petteway,JR,2014-15,G,Nebraska,Big Ten,31,1086,184,465,116,248,68,217,128,180,17,136,153,87,35,27,104,94,564
1465,Torrance Rowe,SR,2015-16,G,Tennessee Tech,OVC,31,1100,177,430,96,194,81,236,129,149,15,70,85,136,18,2,80,35,564
1466,Tyrone Wallace,JR,2014-15,G,University of California,Pac-12,33,1152,208,489,180,401,28,88,120,198,30,205,235,131,42,11,94,91,564
1467,Jonathan Williams,JR,2015-16,G,Toledo,MAC,32,988,207,455,137,269,70,186,80,115,18,77,95,91,26,2,89,62,564
1470,Tim Williams,SO,2013-14,F,Samford,Southern,32,1057,217,361,216,358,1,3,129,172,64,171,235,24,43,45,59,75,564
1471,Martin Zeno,JR,2006-07,G,Texas Tech,Big 12,34,1211,186,376,172,344,14,32,178,225,40,139,179,109,43,9,91,62,564
1472,Desmond Bane,JR,2018-19,G,Texas Christian,Big 12,37,1315,215,428,147,268,68,160,65,75,49,162,211,89,42,20,49,86,563
1473,John Bowler,SR,2005-06,F,Eastern Michigan,MAC,28,938,189,344,187,337,2,7,183,253,91,210,301,70,22,16,106,92,563
1474,Tookie Brown,SO,2016-17,G,Georgia Southern,Sun Belt,33,1123,177,436,116,259,61,177,148,193,8,104,112,131,46,10,73,70,563
1475,Khadeen Carrington,JR,2016-17,G,Seton Hall,Big East,33,1099,189,446,126,281,63,165,122,167,19,83,102,97,38,10,75,62,563
1476,Gilberto Clavell,JR,2009-10,F,Sam Houston State,Southland,33,928,205,358,203,344,2,14,151,207,91,119,210,44,25,5,89,107,563
1477,Elgin Cook,SR,2015-16,F,Oregon,Pac-12,38,1213,191,405,170,342,21,63,160,207,59,136,195,88,54,13,80,107,563
1478,Stephen Croone,SR,2015-16,G,Furman,Southern,33,999,161,376,114,204,47,172,194,253,11,105,116,84,38,10,84,79,563
1479,Jermaine Crumpton,SR,2017-18,F,Canisius,MAAC,33,1063,205,426,158,279,47,147,106,139,66,111,177,50,23,17,59,60,563
1480,TyShwan Edmondson,JR,2010-11,G,Austin Peay,OVC,33,1057,206,487,134,292,72,195,79,106,53,94,147,66,60,15,67,78,563
1481,Andre Harris,SR,2006-07,F,Fairleigh Dickinson,NEC,30,1098,227,463,217,431,10,32,99,145,74,150,224,41,41,37,80,85,563
1482,Danuel House,SR,2015-16,G,Texas A&M,SEC,36,1114,185,467,110,224,75,243,118,165,39,132,171,77,19,11,64,51,563
1483,Jamaal King,JR,2017-18,G,Saint Francis (PA),NEC,31,959,195,412,142,256,53,156,120,147,12,84,96,108,37,1,96,70,563
1484,Stefan Moody,JR,2014-15,G,Mississippi,SEC,34,975,168,433,90,211,78,222,149,165,31,85,116,80,57,3,68,88,563
1485,Chris Oliver,SR,2006-07,F,Radford,Big South,30,1099,220,452,204,390,16,62,107,143,97,152,249,62,56,39,94,55,563
1486,Shawn Roundtree,SR,2018-19,G,Central Michigan,MAC,34,1173,167,364,91,186,76,178,153,194,10,81,91,105,31,2,78,66,563
1487,Tres Tinkle,SO,2017-18,F,Oregon State,Pac-12,32,1164,192,407,144,260,48,147,131,156,56,175,231,117,45,18,93,88,563
1488,Jamarco Warren,SR,2010-11,G,Charleston Southern,Big South,32,1068,180,410,100,193,80,217,123,142,16,79,95,90,44,2,100,70,563
1489,Andrew White III,JR,2015-16,G,Nebraska,Big Ten,34,1010,195,405,108,194,87,211,86,111,40,159,199,20,39,11,53,89,563
1492,Cody Zeller,FR,2011-12,F,Indiana,Big Ten,36,1025,200,321,200,321,0,0,163,216,87,149,236,45,49,42,60,97,563
1493,Joshua Braun,SO,2015-16,G,Grand Canyon,WAC,34,1045,143,328,70,142,73,186,203,234,56,122,178,37,26,23,44,71,562
1494,J'Nathan Bullock,SR,2008-09,F,Cleveland State,Horizon,37,1184,192,455,156,338,36,117,142,193,73,188,261,51,36,15,56,76,562
1495,Dachon Burke,SO,2017-18,G,Robert Morris,NEC,32,1044,210,458,166,328,44,130,98,156,59,125,184,80,67,16,86,81,562
1496,Jordan Caroline,SR,2018-19,F,Nevada,MWC,33,1171,193,427,147,302,46,125,130,207,83,235,318,63,21,10,82,72,562
1497,Herb Courtney,JR,2006-07,F,Delaware,CAA,31,1139,191,451,150,322,41,129,139,196,52,196,248,39,45,54,88,87,562
1498,Jordan Gregory,SR,2014-15,G,Montana,Big Sky,33,1189,176,437,89,209,87,228,123,154,18,93,111,107,20,1,70,53,562
1499,Manny Harris,JR,2009-10,G,Michigan,Big Ten,31,1120,181,430,133,274,48,156,152,190,57,130,187,126,56,11,88,45,562
1500,Rodney Hood,SO,2013-14,F,Duke,ACC,35,1150,191,412,120,243,71,169,109,135,29,109,138,75,25,9,54,91,562
1501,Yante Maten,SO,2015-16,F,Georgia,SEC,34,1020,212,427,204,412,8,15,130,166,89,184,273,27,9,62,76,92,562
1502,Ryan Pearson,SR,2011-12,F,George Mason,CAA,33,1012,201,400,173,320,28,80,132,182,76,195,271,58,43,15,89,86,562
1503,Bruce Price,JR,2007-08,G,Tennessee State,OVC,32,1089,160,395,106,229,54,166,188,268,29,122,151,160,71,2,128,96,562
1504,Coby White,FR,2018-19,G,North Carolina,ACC,35,999,188,444,106,212,82,232,104,130,12,112,124,143,38,11,93,68,562
1505,Jamal Barney,SO,2008-09,G,Loyola (MD),MAAC,31,887,207,498,178,395,29,103,118,148,54,115,169,40,44,14,79,75,561
1506,Landon Clement,JR,2010-11,G,North Carolina Central,Ind,30,1081,183,424,74,156,109,268,86,107,16,96,112,32,34,1,43,43,561
1507,Kellen Dunham,JR,2014-15,G,Butler,Big East,34,1153,171,399,94,211,77,188,142,167,18,69,87,31,19,1,51,47,561
1508,Henry Ellenson,FR,2015-16,F,Marquette,Big East,33,1107,194,435,164,331,30,104,143,191,71,250,321,59,28,49,78,84,561
1509,C.J. Fair,SR,2013-14,F,Syracuse,ACC,34,1284,217,506,193,419,24,87,103,142,59,160,219,43,44,27,85,71,561
1510,Brian Fobbs,JR,2018-19,G,Towson,CAA,32,1049,207,457,142,280,65,177,82,102,59,129,188,41,21,7,59,58,561
1511,Jamont Gordon,SO,2006-07,G,Mississippi State,SEC,35,1129,181,432,139,311,42,121,157,222,43,207,250,187,46,20,123,85,561
1512,B.J. Johnson,SR,2017-18,G,La Salle,A-10,27,951,194,435,147,304,47,131,126,145,57,168,225,20,35,19,68,57,561
1513,Carl Jones,JR,2011-12,G,Saint Joseph's,A-10,33,1204,176,423,114,245,62,178,147,186,10,100,110,108,40,1,92,56,561
1514,Dominique Jones,SO,2008-09,G,South Florida,Big East,31,1161,193,461,139,286,54,175,121,171,61,112,173,122,41,12,82,79,561
1515,Kyle Landry,SR,2007-08,F,Northern Arizona,Big Sky,32,815,189,323,189,323,0,0,183,259,89,169,258,28,32,27,49,86,561
1516,Z Mason,SR,2013-14,F,Chattanooga,Southern,31,939,201,410,161,293,40,117,119,167,91,209,300,24,28,92,74,72,561
1517,Matt Scott,JR,2016-17,G,Niagara,MAAC,33,1139,187,430,122,257,65,173,122,170,56,174,230,99,45,14,87,79,561
1518,Elston Turner,SR,2012-13,G,Texas A&M,SEC,32,1139,199,467,125,262,74,205,89,105,14,82,96,74,31,7,59,38,561
1519,Kyle Weems,JR,2010-11,F,Missouri State,MVC,35,1087,204,428,138,261,66,167,87,110,57,183,240,49,48,33,50,93,561
1520,Kamar Baldwin,JR,2018-19,G,Butler,Big East,33,1129,211,472,169,337,42,135,96,113,21,140,161,102,49,11,90,86,560
1521,Jordan Davis,SO,2016-17,G,Northern Colorado,Big Sky,29,978,210,429,185,345,25,84,115,192,20,120,140,162,35,15,126,84,560
1522,Jud Dillard,SR,2012-13,F,Tennessee Tech,OVC,29,982,182,404,146,297,36,107,160,197,57,169,226,67,31,8,87,73,560
1523,Anthony Gurley,SR,2010-11,G,Massachusetts,A-10,30,920,193,462,133,290,60,172,114,156,24,107,131,42,29,2,83,57,560
1524,Herbert Hill,SR,2006-07,F,Providence,Big East,31,990,240,375,240,374,0,1,80,133,101,173,274,45,30,91,89,90,560
1525,DeAndre Kane,SO,2011-12,G,Marshall,CUSA,34,1156,201,486,170,362,31,124,127,212,70,115,185,120,47,11,101,110,560
1526,Roy Devyn Marble,SR,2013-14,G,Iowa,Big Ten,33,995,183,436,131,287,52,149,142,199,26,80,106,118,60,7,57,64,560
1527,Gerry McNamara,SR,2005-06,G,Syracuse,Big East,35,1232,173,490,70,182,103,308,111,123,32,62,94,207,66,2,117,46,560
1528,Kevin Murphy,JR,2010-11,G,Tennessee Tech,OVC,33,966,202,423,165,312,37,111,119,162,18,130,148,58,34,6,107,72,560
1529,Cameron Oliver,SO,2016-17,F,Nevada,MWC,35,1115,202,434,136,262,66,172,90,130,57,247,304,64,29,91,83,101,560
1530,Christian Standhardinger,SR,2013-14,F,Hawaii,Big West,31,989,176,371,163,324,13,47,195,254,92,169,261,46,42,23,85,89,560
1531,Darryl Bryant,SR,2011-12,G,West Virginia,Big East,33,1230,157,438,86,208,71,230,174,222,27,74,101,89,45,2,80,72,559
1534,Torrey Craig,SO,2011-12,F,South Carolina Upstate,A-Sun,34,1010,194,446,111,208,83,238,88,129,80,183,263,52,45,37,92,93,559
1535,David Efianayi,JR,2017-18,G,Gardner-Webb,Big South,32,1042,183,419,132,278,51,141,142,176,19,97,116,81,40,7,82,54,559
1536,Josh Greene,SR,2013-14,G,Cal State Northridge,Big West,35,1256,156,382,78,201,78,181,169,185,12,92,104,115,38,6,69,85,559
1537,Blake Hamilton,SR,2016-17,F,Buffalo,MAC,32,974,189,437,130,277,59,160,122,157,27,171,198,141,32,15,111,92,559
1538,Marvelle Harris,SO,2013-14,G,Fresno State,MWC,39,1349,177,425,122,272,55,153,150,194,30,175,205,75,40,13,58,92,559
1539,Chris Lofton,SR,2007-08,G,Tennessee,SEC,36,1071,170,426,52,119,118,307,101,120,27,88,115,64,48,3,49,56,559
1540,Kalin Lucas,SO,2008-09,G,Michigan State,Big Ten,38,1213,173,438,132,333,41,105,172,213,26,54,80,176,39,6,84,49,559
1541,Brandon McCoy,FR,2017-18,F,Nevada-Las Vegas,MWC,33,949,208,382,205,373,3,9,140,193,103,238,341,17,15,60,87,87,559
1542,Lamont Middleton,SR,2013-14,G,North Carolina A&T,MEAC,32,1123,140,428,90,263,50,165,229,291,45,106,151,66,33,5,95,77,559
1543,Darrion Pellum,JR,2010-11,G,Hampton,MEAC,32,1172,188,484,115,267,73,217,110,154,23,115,138,63,53,10,92,70,559
1544,Jaylen Shaw,JR,2016-17,G,Coastal Carolina,Sun Belt,39,1194,203,441,144,292,59,149,94,116,15,114,129,148,53,5,88,73,559
1545,TaShawn Thomas,SO,2012-13,F,Houston,CUSA,33,1072,234,424,233,415,1,9,90,141,98,224,322,79,34,55,69,78,559
1546,Tony Wroten,FR,2011-12,G,Washington,Pac-12,35,1062,198,447,189,391,9,56,154,264,80,96,176,130,66,13,132,93,559
1547,Bryce Alford,SR,2016-17,G,UCLA,Pac-12,36,1188,173,387,57,117,116,270,96,117,11,78,89,92,19,5,35,51,558
1548,Joel Berry,JR,2016-17,G,North Carolina,ACC,38,1155,182,427,94,197,88,230,106,137,16,102,118,138,53,5,71,84,558
1549,John Bryant,JR,2007-08,C,Santa Clara,WCC,31,862,214,367,214,366,0,1,130,175,78,220,298,21,15,76,86,93,558
1550,Rotnei Clarke,SR,2012-13,G,Butler,A-10,33,1099,183,444,68,162,115,282,77,86,14,79,93,90,24,1,94,54,558
1551,Sherron Collins,SR,2009-10,G,Kansas,Big 12,36,1187,185,434,115,245,70,189,118,138,8,67,75,161,39,2,85,60,558
1552,Dylon Cormier,JR,2012-13,G,Loyola (MD),MAAC,34,1195,179,434,151,331,28,103,172,232,75,80,155,84,62,11,61,66,558
1553,Robert Hite,SR,2005-06,G,Miami (FL),ACC,34,1127,201,446,116,239,85,207,71,87,46,152,198,48,50,10,55,78,558
1556,Rapolas Ivanauskas,JR,2018-19,F,Colgate,Patriot,35,1058,207,400,164,301,43,99,101,130,64,208,272,56,19,21,86,103,558
1557,Shawn Long,JR,2014-15,F,Louisiana,Sun Belt,34,951,205,378,177,301,28,77,120,182,103,243,346,50,22,56,78,106,558
1558,Jarell Martin,SO,2014-15,F,Louisiana State,SEC,33,1159,202,397,188,345,14,52,140,203,98,207,305,59,38,23,92,92,558
1559,Derek Needham,FR,2009-10,G,Fairfield,MAAC,34,1240,187,490,129,301,58,189,126,174,22,87,109,177,60,4,130,94,558
1560,Shavar Newkirk,SR,2017-18,G,Saint Joseph's,A-10,32,1092,172,443,120,284,52,159,162,212,25,114,139,125,50,7,56,57,558
1561,Marcus Romain,JR,2015-16,G,Mississippi Valley State,SWAC,30,869,188,429,158,341,30,88,152,200,30,131,161,71,34,11,108,69,558
1562,Jarnell Stokes,JR,2013-14,F,Tennessee,SEC,37,1199,199,375,199,375,0,0,160,230,155,237,392,75,26,34,77,73,558
1563,Zach Thomas,JR,2016-17,F,Bucknell,Patriot,35,1041,181,382,125,245,56,137,140,172,39,191,230,120,39,17,108,82,558
1564,Aaron White,SR,2014-15,F,Iowa,Big Ten,34,1070,171,328,150,269,21,59,195,238,71,177,248,48,45,16,41,53,558
1565,James Batemon,SR,2018-19,G,Loyola Marymount,WCC,34,1201,174,413,131,262,43,151,166,202,21,84,105,122,54,1,103,79,557
1566,Murphy Burnatowski,SR,2012-13,F,Colgate,Patriot,32,974,203,474,134,277,69,197,82,112,45,119,164,41,40,25,63,80,557
1567,Brandon Clark,JR,2013-14,G,Santa Clara,WCC,33,1058,178,419,122,259,56,160,145,167,26,61,87,116,46,4,62,88,557
1568,Garret Covington,SR,2016-17,G,Western Illinois,Summit,28,974,178,428,92,200,86,228,115,131,10,91,101,89,21,2,80,50,557
1569,Mo Evans,SR,2016-17,G,Purdue-Fort Wayne,Summit,33,1054,197,425,97,194,100,231,63,76,14,88,102,205,51,5,103,80,557
1570,Jamaal Franklin,SO,2011-12,G,San Diego State,MWC,32,969,173,400,122,243,51,157,160,200,57,195,252,47,31,20,95,81,557
1571,Jeremy Harris,JR,2017-18,G,Buffalo,MAC,36,1197,203,431,111,211,92,220,59,75,48,164,212,77,36,26,46,76,557
1572,Chandler Hutchison,JR,2016-17,G,Boise State,MWC,32,1014,207,418,181,349,26,69,117,176,38,212,250,84,39,6,86,87,557
1573,Kawhi Leonard,SO,2010-11,F,San Diego State,MWC,36,1172,211,475,186,389,25,86,110,145,111,269,380,91,51,21,76,89,557
1574,Nick Mayo,JR,2017-18,F,Eastern Kentucky,OVC,31,1062,202,384,169,310,33,74,120,143,47,161,208,67,24,46,98,88,557
1575,Mickey McConnell,SR,2010-11,G,Saint Mary's (CA),WCC,34,1255,177,351,100,182,77,169,126,142,16,70,86,206,42,7,79,61,557
1578,Kwamain Mitchell,SO,2009-10,G,Saint Louis,A-10,35,1148,200,444,136,266,64,178,93,130,18,88,106,106,50,2,86,81,557
1579,Isaiah Reese,SO,2017-18,G,Canisius,MAAC,33,1102,200,432,117,201,83,231,74,84,18,172,190,154,73,5,87,71,557
1580,Tyrese Rice,SR,2008-09,G,Boston College,ACC,33,1101,162,392,101,216,61,176,172,201,28,99,127,176,47,7,125,93,557
1581,Marcus Smart,SO,2013-14,G,Oklahoma State,Big 12,31,1014,163,386,114,222,49,164,182,250,44,139,183,148,89,18,82,91,557
1582,Trey Sumler,SR,2013-14,G,Western Carolina,Southern,32,1138,177,422,115,253,62,169,141,176,32,95,127,138,36,0,72,75,557
1583,Jordan Williams,SO,2010-11,F,Maryland,ACC,33,1073,213,396,213,396,0,0,131,228,121,267,388,21,23,45,53,80,557
1584,Chris Clemons,FR,2015-16,G,Campbell,Big South,30,965,186,439,94,193,92,246,92,109,10,101,111,54,45,8,57,75,556
1585,Lee Cummard,SR,2008-09,G,Brigham Young,MWC,33,1081,199,385,163,292,36,93,122,140,47,158,205,111,30,30,54,82,556
1586,Sam Dekker,JR,2014-15,F,Wisconsin,Big Ten,40,1239,213,406,163,255,50,151,80,113,77,143,220,49,21,18,36,42,556
1587,Damyean Dotson,SR,2016-17,G,Houston,AAC,32,1098,202,430,94,186,108,244,44,53,49,173,222,36,29,5,33,53,556
1588,Tyler Johnson,SR,2013-14,G,Fresno State,MWC,35,1177,196,409,139,277,57,132,107,133,56,200,256,103,36,13,47,98,556
1589,Aleks Maric,JR,2006-07,C,Nebraska,Big 12,30,864,203,359,200,349,3,10,147,216,75,185,260,24,15,33,97,80,556
1590,Tywain McKee,SO,2006-07,G,Coppin State,MEAC,32,1087,180,449,124,272,56,177,140,182,56,83,139,98,64,5,100,83,556
1591,Tony Murphy,SR,2007-08,G,Norfolk State,MEAC,31,1085,181,493,108,256,73,237,121,146,17,78,95,76,54,3,104,30,556
1592,Rob Poole,JR,2013-14,G,Siena,MAAC,38,1289,177,429,106,232,71,197,131,171,48,142,190,61,41,5,66,83,556
1593,Curtis Sumpter,SR,2006-07,F,Villanova,Big East,32,975,182,407,130,265,52,142,140,174,82,148,230,28,30,28,70,97,556
1594,Melo Trimble,JR,2016-17,G,Maryland,Big Ten,33,1059,180,413,122,230,58,183,138,175,9,110,119,121,36,5,100,59,556
1595,Mike Trimboli,JR,2007-08,G,Vermont,AEC,31,1130,186,425,123,248,63,177,121,140,25,91,116,139,41,6,114,81,556
1596,LaMarcus Aldridge,SO,2005-06,F,Texas,Big 12,37,1247,219,385,219,385,0,0,117,181,135,204,339,20,50,73,59,92,555
1597,Amanze Egekeze,SR,2017-18,F,Belmont,OVC,33,1139,185,365,89,139,96,226,89,111,39,166,205,31,19,8,42,61,555
1600,Yogi Ferrell,JR,2014-15,G,Indiana,Big Ten,34,1186,181,412,99,215,82,197,111,129,21,89,110,166,24,1,65,59,555
1601,Charron Fisher,JR,2006-07,F,Niagara,MAAC,27,904,188,412,151,310,37,102,142,185,75,142,217,29,23,13,80,68,555
1602,Mike Gansey,SR,2005-06,F,West Virginia,Big East,33,1114,204,371,129,196,75,175,72,105,65,124,189,64,62,10,43,32,555
1603,Darington Hobson,JR,2009-10,F,New Mexico,MWC,35,1175,193,439,154,331,39,108,130,199,74,250,324,160,44,15,104,68,555
1604,David Kool,JR,2008-09,G,Western Michigan,MAC,31,1058,168,429,110,234,58,195,161,180,15,112,127,62,44,0,84,72,555
1605,Trey Lewis,JR,2014-15,G,Cleveland State,Horizon,33,1172,186,417,90,190,96,227,87,115,26,118,144,92,40,5,76,65,555
1606,Ray McCallum,SO,2011-12,G,Detroit Mercy,Horizon,36,1213,192,419,162,294,30,125,141,184,37,126,163,143,57,7,80,74,555
1607,Sam Merrill,SO,2017-18,G,Utah State,MWC,34,1202,192,381,94,170,98,211,73,86,7,104,111,107,35,7,62,75,555
1608,Carl Montgomery,SR,2010-11,F,Chicago State,GWC,32,879,209,398,206,384,3,14,134,217,98,160,258,35,20,31,76,101,555
1609,Tanner Plomb,SR,2015-16,F,Army,Patriot,28,879,190,449,110,222,80,227,95,129,17,144,161,42,25,8,48,48,555
1610,Scottie Reynolds,SO,2007-08,G,Villanova,Big East,35,1139,164,398,85,192,79,206,148,190,17,90,107,113,51,1,107,75,555
1611,Rayvonte Rice,JR,2013-14,G,Illinois,Big Ten,35,1146,192,447,146,291,46,156,125,171,44,166,210,53,58,12,55,86,555
1612,Rayvonte Rice,SO,2011-12,G,Drake,MVC,33,1101,190,436,163,324,27,112,148,209,42,148,190,52,63,25,83,103,555
1613,Eric Williams,SR,2005-06,C,Wake Forest,ACC,34,1107,223,360,223,360,0,0,109,221,107,194,301,34,44,37,77,87,555
1614,Matt Witt,SR,2005-06,G,Eastern Kentucky,OVC,30,1010,186,446,89,186,97,260,86,107,8,59,67,132,34,2,99,56,555
1615,Marquis Wright,SR,2016-17,G,Siena,MAAC,33,1127,191,467,138,316,53,151,120,163,43,94,137,165,37,5,93,71,555
1616,Bryce Alford,SO,2014-15,G,UCLA,Pac-12,36,1307,171,432,78,194,93,238,119,142,6,108,114,176,34,1,89,54,554
1617,Jamar Butler,SR,2007-08,G,Ohio State,Big Ten,37,1341,184,428,80,157,104,271,82,87,13,96,109,219,49,1,99,47,554
1618,Osiris Eldridge,SO,2007-08,G,Illinois State,MVC,35,1085,196,454,112,236,84,218,78,107,56,143,199,68,47,11,75,70,554
1619,Chris Flemmings,SR,2016-17,G,North Carolina-Wilmington,CAA,35,1216,193,409,123,210,70,199,98,127,39,157,196,76,48,26,76,68,554
1620,Rodney Green,SR,2009-10,G,La Salle,A-10,30,1113,204,491,169,359,35,132,111,158,28,126,154,128,48,7,120,56,554
1621,Roy Devyn Marble,JR,2012-13,G,Iowa,Big Ten,37,1130,176,430,127,280,49,150,153,189,34,113,147,112,42,10,80,50,554
1622,Dallas Moore,SO,2014-15,G,North Florida,A-Sun,35,1139,211,439,150,282,61,157,71,97,33,78,111,128,35,1,82,42,554
1623,Anthony Raffa,SR,2012-13,G,Coastal Carolina,Big South,29,945,199,426,139,256,60,170,96,127,23,81,104,42,55,6,57,66,554
1624,Matt Scott,SR,2017-18,G,Niagara,MAAC,29,959,179,422,131,270,48,152,148,208,69,144,213,75,33,14,63,59,554
1625,Deonta Vaughn,SO,2007-08,G,Cincinnati,Big East,32,1069,178,408,81,164,97,244,101,128,16,78,94,133,31,2,101,90,554
1626,Chris Warren,FR,2007-08,G,Mississippi,SEC,35,1097,183,462,80,197,103,265,85,106,8,63,71,156,38,5,103,82,554
1627,Oshae Brissett,FR,2017-18,F,Syracuse,ACC,37,1411,162,458,107,292,55,166,174,221,82,245,327,34,43,29,69,83,553
1628,Joe Cremo,SO,2016-17,G,Albany (NY),AEC,35,1241,185,409,135,276,50,133,133,153,27,157,184,134,37,5,92,60,553
1629,Matthew Dellavedova,SR,2012-13,G,Saint Mary's (CA),WCC,35,1273,170,421,84,196,86,225,127,149,23,95,118,223,40,4,99,61,553
1630,Blake Francis,SO,2017-18,G,Wagner,NEC,32,1046,182,423,80,169,102,254,87,108,20,40,60,54,52,1,48,81,553
1631,Diante Garrett,SR,2010-11,G,Iowa State,Big 12,32,1175,214,518,155,333,59,185,66,80,12,107,119,195,55,7,106,55,553
1632,Treveon Graham,JR,2013-14,G,Virginia Commonwealth,A-10,35,989,185,423,127,251,58,172,125,180,69,176,245,70,32,6,63,83,553
1633,Nate Harris,SR,2005-06,F,Utah State,WAC,32,1068,215,346,208,328,7,18,116,156,74,173,247,97,23,31,68,69,553
1634,Demetrius Jackson,JR,2015-16,G,Notre Dame,ACC,35,1259,193,428,139,265,54,163,113,139,31,90,121,164,43,10,76,68,553
1635,Kevin McClain,SR,2018-19,G,Belmont,OVC,33,1101,185,399,115,208,70,191,113,161,15,104,119,130,39,8,73,60,553
1636,Ramone Moore,SR,2011-12,G,Temple,A-10,32,1170,195,458,138,309,57,149,106,139,29,109,138,110,35,5,82,78,553
1637,Malik Newman,SO,2017-18,G,Kansas,Big 12,39,1234,186,402,101,197,85,205,96,115,20,176,196,82,42,6,57,61,553
1638,Derick Newton,FR,2015-16,F,Stetson,A-Sun,34,1061,171,384,114,262,57,122,154,186,52,148,200,46,15,15,81,63,553
1639,Leon Powe,SO,2005-06,F,University of California,Pac-10,27,953,178,359,175,350,3,9,194,270,89,184,273,38,24,15,66,67,553
1642,Marcquise Reed,JR,2017-18,G,Clemson,ACC,35,1221,183,426,116,237,67,189,120,142,26,139,165,116,58,0,80,67,553
1643,Jaelan Sanford,JR,2017-18,G,Toledo,MAC,34,1175,186,412,115,236,71,176,110,130,21,96,117,101,20,19,62,61,553
1644,Michael Thompson,SR,2010-11,G,Northwestern,Big Ten,34,1268,189,418,94,176,95,242,80,97,12,62,74,147,49,2,64,75,553
1645,Terry Allen,SR,2015-16,F,Richmond,A-10,32,1065,193,392,169,314,24,78,142,195,66,179,245,69,52,19,59,83,552
1646,Nick Calathes,FR,2007-08,G,Florida,SEC,36,1174,175,411,117,253,58,158,144,199,41,146,187,221,58,3,104,76,552
1647,Gian Clavell,SR,2016-17,G,Colorado State,MWC,27,987,193,449,115,247,78,202,88,127,37,133,170,47,53,20,53,58,552
1648,D.J. Cooper,SO,2010-11,G,Ohio,MAC,35,1248,180,471,122,277,58,194,134,179,43,133,176,263,81,9,123,74,552
1649,Lee Cummard,JR,2007-08,G,Brigham Young,MWC,35,1101,198,348,138,221,60,127,96,112,69,153,222,123,33,35,79,93,552
1650,Will Darley,SR,2016-17,G,Maryland-Baltimore County,AEC,34,1040,182,373,92,170,90,203,98,110,33,100,133,64,15,3,60,80,552
1651,Ledrick Eackles,SR,2013-14,G,McNeese State,Southland,31,979,159,435,81,221,78,214,156,204,37,116,153,73,48,5,91,78,552
1652,Yogi Ferrell,SO,2013-14,G,Indiana,Big Ten,32,1083,169,409,81,189,88,220,126,153,9,86,95,125,24,1,84,54,552
1653,Kalin Fisher,SR,2018-19,G,Hampton,Big South,35,1216,182,455,127,278,55,177,133,165,14,149,163,112,65,6,74,87,552
1654,Temple Gibbs,SO,2017-18,G,Notre Dame,ACC,36,1348,171,416,90,215,81,201,129,154,28,73,101,107,37,3,54,65,552
1655,Tim Hardaway,JR,2012-13,G,Michigan,Big Ten,38,1324,201,460,128,265,73,195,77,111,9,168,177,93,26,17,71,73,552
1656,Brandon Hazzard,SR,2009-10,G,Troy,Sun Belt,33,1092,186,450,103,233,83,217,97,130,10,56,66,52,37,0,77,66,552
1657,Erick Neal,SR,2017-18,G,Texas-Arlington,Sun Belt,33,1138,188,433,95,191,93,242,83,109,24,114,138,222,65,3,122,79,552
1658,Joakim Noah,SO,2005-06,C,Florida,SEC,39,972,202,322,202,321,0,1,148,202,85,193,278,80,44,95,76,84,552
1659,Zach Norvell Jr.,SO,2018-19,G,Gonzaga,WCC,37,1135,182,419,85,157,97,262,91,105,29,130,159,116,47,3,53,67,552
1660,Giddy Potts,JR,2016-17,G,Middle Tennessee,CUSA,36,1098,196,407,120,209,76,198,84,104,33,159,192,72,47,8,47,87,552
1661,Omar Prewitt,JR,2015-16,G,William & Mary,CAA,31,998,188,381,145,263,43,118,133,189,26,136,162,77,24,16,59,71,552
1664,Devon Saddler,SR,2013-14,G,Delaware,CAA,28,1037,190,433,143,305,47,128,125,176,30,89,119,101,24,7,61,61,552
1665,Cameron Wells,SR,2010-11,G,Citadel,Southern,32,1145,197,451,178,374,19,77,139,168,18,144,162,138,46,11,78,63,552
1666,Jake White,SR,2015-16,F,Omaha,Summit,32,829,197,347,175,304,22,43,136,168,74,125,199,10,10,7,48,97,552
1667,Brandon Wood,JR,2010-11,G,Valparaiso,Horizon,33,1053,207,447,146,279,61,168,77,116,32,110,142,103,55,6,72,51,552
1668,Jamie Adams,SR,2013-14,G,Florida A&M,MEAC,32,969,157,399,80,195,77,204,160,202,17,63,80,118,48,1,103,84,551
1669,Ian Baker,SR,2016-17,G,New Mexico State,WAC,33,1079,164,421,101,216,63,205,160,193,17,123,140,137,42,4,74,55,551
1670,Tookie Brown,FR,2015-16,G,Georgia Southern,Sun Belt,31,956,177,408,127,274,50,134,147,181,18,82,100,104,51,4,69,81,551
1671,Kannon Burrage,SR,2012-13,G,Texas-San Antonio,WAC,32,1120,184,485,126,312,58,173,125,164,54,104,158,43,29,2,78,60,551
1672,Tre Bussey,SR,2013-14,G,Georgia Southern,Southern,34,1186,197,431,140,283,57,148,100,151,36,92,128,66,33,3,51,40,551
1673,Thomas Gardner,JR,2005-06,G,Missouri,Big 12,28,957,186,434,92,197,94,237,85,118,31,59,90,45,27,0,92,59,551
1674,Rodney Green,JR,2008-09,G,La Salle,A-10,31,1093,199,418,170,334,29,84,124,176,30,124,154,105,58,5,100,79,551
1675,Nigel Hayes,JR,2015-16,F,Wisconsin,Big Ten,35,1267,161,438,122,305,39,133,190,258,69,135,204,104,39,14,79,71,551
1676,Trevor Lacey,JR,2014-15,G,North Carolina State,ACC,35,1256,190,436,112,237,78,199,93,126,27,133,160,121,31,7,67,56,551
1677,Tayler Persons,SR,2018-19,G,Ball State,MAC,33,1058,199,451,154,311,45,140,108,135,12,119,131,143,35,4,107,68,551
1678,Jamarr Sanders,SR,2010-11,G,Alabama-Birmingham,CUSA,31,1080,197,462,107,229,90,233,67,83,29,113,142,58,27,10,91,60,551
1679,Steven Smith,SR,2005-06,F,La Salle,A-10,28,1009,208,428,182,351,26,77,109,141,58,162,220,69,32,23,100,72,551
1680,Ovie Soko,SR,2013-14,F,Duquesne,A-10,30,930,171,366,157,315,14,51,195,289,61,179,240,50,26,19,80,95,551
1681,Ameen Tanksley,JR,2014-15,G,Hofstra,CAA,34,1105,180,402,106,216,74,186,117,169,60,128,188,49,48,8,68,82,551
1682,Ken Tutt,SR,2006-07,G,Oral Roberts,Mid-Cont,34,1209,184,447,100,230,84,217,99,135,12,74,86,84,36,4,94,58,551
1683,Cameron Wells,JR,2009-10,G,Citadel,Southern,32,1131,196,480,179,415,17,65,142,164,39,142,181,132,47,12,69,69,551
1686,Rashad West,JR,2006-07,G,Hampton,MEAC,31,960,160,405,88,222,72,183,159,198,31,80,111,82,58,0,107,76,551
1687,C.J. Wilkerson,SR,2010-11,G,North Carolina Central,Ind,29,1077,160,344,116,232,44,112,187,251,17,81,98,53,30,2,94,73,551
1688,Frank Young,SR,2006-07,F,West Virginia,Big East,36,1152,189,425,72,155,117,270,56,77,45,112,157,65,49,7,61,71,551
1689,Joe Zeglinski,SO,2007-08,G,Hartford,AEC,34,1196,190,433,87,182,103,251,68,96,43,91,134,89,28,4,70,77,551
1690,Nickeil Alexander-Walker,SO,2018-19,G,Virginia Tech,ACC,34,1167,190,401,132,246,58,155,112,144,16,123,139,135,64,18,97,78,550
1691,Tyus Battle,JR,2018-19,G,Syracuse,ACC,32,1162,188,436,146,305,42,131,132,173,21,84,105,80,37,8,57,68,550
1692,DeAndre Bembry,SO,2014-15,F,Saint Joseph's,A-10,31,1197,199,461,149,308,50,153,102,160,49,191,240,111,60,29,89,73,550
1693,DeJuan Blair,SO,2008-09,F,Pittsburgh,Big East,35,955,226,381,226,381,0,0,98,162,195,237,432,42,54,34,44,95,550
1694,Marqus Blakely,SO,2007-08,F,Vermont,AEC,29,986,198,360,197,354,1,6,153,271,110,210,320,67,57,79,73,80,550
1695,Craig Bradshaw,JR,2014-15,G,Belmont,OVC,30,950,197,401,115,207,82,194,74,99,14,101,115,94,48,11,93,62,550
1696,Jason Burnell,SR,2018-19,F,Jacksonville State,OVC,32,1081,194,383,165,292,29,91,133,166,100,208,308,98,34,29,66,89,550
1697,James Florence,SR,2009-10,G,Mercer,A-Sun,31,1027,173,427,116,246,57,181,147,197,19,78,97,142,54,12,116,90,550
1698,Chris Fouch,SR,2013-14,G,Drexel,CAA,30,1062,186,466,114,244,72,222,106,129,20,77,97,60,26,3,38,83,550
1699,Harald Frey,JR,2018-19,G,Montana State,Big Sky,32,1056,169,384,94,190,75,194,137,162,26,117,143,159,39,0,61,65,550
1700,Sheldon McClellan,JR,2014-15,G,Miami (FL),ACC,38,1278,192,397,138,246,54,151,112,136,32,146,178,74,34,7,49,59,550
1701,Jon Scheyer,JR,2008-09,G,Duke,ACC,37,1214,146,368,67,163,79,205,179,214,42,92,134,102,58,6,57,62,550
1702,Trevis Simpson,SO,2011-12,G,North Carolina-Greensboro,Southern,30,835,186,486,125,290,61,196,117,155,43,84,127,22,23,6,67,92,550
1703,Jarvis Williams,SR,2014-15,F,Murray State,OVC,35,1085,199,351,199,350,0,1,152,228,135,158,293,32,26,35,48,95,550
1704,Milik Yarbrough,SR,2018-19,G,Illinois State,MVC,33,966,202,438,169,341,33,97,113,145,32,196,228,101,24,18,133,86,550
1705,Desmond Yates,JR,2008-09,F,Middle Tennessee,Sun Belt,32,964,228,394,208,334,20,60,74,94,44,101,145,8,20,13,58,103,550
1708,Javon Bess,SR,2018-19,G,Saint Louis,A-10,36,1323,172,437,106,234,66,203,139,176,40,204,244,64,50,8,45,83,549
1709,Craig Bradshaw,SO,2013-14,G,Belmont,OVC,35,1080,191,378,126,214,65,164,102,126,27,94,121,111,45,7,94,74,549
1710,John Brown,SR,2015-16,F,High Point,Big South,28,830,212,352,211,351,1,1,124,177,91,108,199,62,48,49,48,60,549
1711,Antonius Cleveland,SR,2016-17,G,Southeast Missouri State,OVC,33,1086,208,383,180,310,28,73,105,159,28,141,169,73,47,30,66,85,549
1712,Will Figures,SR,2009-10,G,Northern Colorado,Big Sky,33,1058,151,358,92,215,59,143,188,221,25,95,120,91,34,1,76,80,549
1713,Anthony Fisher,JR,2006-07,G,Tennessee Tech,OVC,32,1114,160,384,98,198,62,186,167,209,23,99,122,136,32,4,82,75,549
1714,Chad Frazier,JR,2013-14,G,Alabama-Birmingham,CUSA,31,1095,170,424,109,244,61,180,148,203,17,86,103,132,35,10,123,62,549
1715,Montrezl Harrell,JR,2014-15,F,Louisville,ACC,35,1229,213,376,204,339,9,37,114,191,111,210,321,49,33,42,69,74,549
1716,Aaron Harrison,FR,2013-14,G,Kentucky,SEC,40,1303,174,411,112,237,62,174,139,176,25,93,118,74,43,12,65,85,549
1717,Zaid Hearst,SR,2014-15,G,Quinnipiac,MAAC,30,1106,197,456,157,312,40,144,115,149,69,113,182,76,15,10,67,66,549
1718,Tamir Jackson,SR,2012-13,G,Rice,CUSA,31,1090,196,506,149,332,47,174,110,158,44,142,186,78,42,2,90,81,549
1719,Doron Lamb,SO,2011-12,G,Kentucky,SEC,40,1249,175,369,99,206,76,163,123,149,15,93,108,60,19,2,44,72,549
1720,Greg Monroe,SO,2009-10,C,Georgetown,Big East,34,1164,202,385,195,358,7,27,138,209,74,254,328,128,42,52,112,87,549
1721,Andy Ogide,SR,2010-11,F,Colorado State,MWC,32,944,215,366,206,342,9,24,110,169,76,170,246,21,26,18,75,90,549
1722,Ladarius Tabb,SR,2015-16,G,Alabama A&M,SWAC,29,1000,201,457,156,304,45,153,102,160,58,143,201,21,41,8,50,73,549
1723,Trey Thompkins,SO,2009-10,F,Georgia,SEC,31,962,207,429,184,368,23,61,112,147,65,193,258,60,30,36,91,81,549
1724,Quinton Upshur,SR,2014-15,G,Northern Arizona,Big Sky,38,1131,172,454,90,207,82,247,123,165,20,110,130,44,33,41,48,106,549
1725,Nick Aldridge,FR,2006-07,F,Western Carolina,Southern,30,975,203,440,194,403,9,37,133,211,78,132,210,50,50,10,81,82,548
1726,Kamar Baldwin,SO,2017-18,G,Butler,Big East,35,1191,210,475,161,327,49,148,79,102,13,159,172,111,54,15,75,89,548
1727,Ignas Brazdeikis,FR,2018-19,F,Michigan,Big Ten,37,1096,188,407,132,264,56,143,116,150,43,158,201,31,26,18,46,79,548
1728,Vladimir Brodziansky,JR,2016-17,F,Texas Christian,Big 12,39,934,203,360,192,330,11,30,131,169,85,137,222,24,13,82,42,81,548
1729,Quinton Day,JR,2005-06,G,Missouri-Kansas City,Mid-Cont,27,1037,186,460,113,264,73,196,103,127,17,81,98,130,76,0,108,46,548
1730,Matt Dickey,SR,2011-12,G,North Carolina-Asheville,Big South,34,1130,152,339,90,170,62,169,182,210,26,87,113,124,50,2,81,76,548
1731,Ella Ellis,SR,2012-13,F,Army,Patriot,31,839,149,332,77,160,72,172,178,209,25,92,117,44,21,20,66,71,548
1732,Jonny Flynn,FR,2007-08,G,Syracuse,Big East,35,1243,191,416,135,255,56,161,110,142,22,72,94,185,53,6,95,51,548
1733,K.T. Harrell,JR,2013-14,G,Auburn,SEC,30,979,174,402,108,218,66,184,134,154,20,99,119,64,24,6,86,77,548
1734,George Hill,SO,2005-06,G,IUPUI,Mid-Cont,29,1019,175,338,159,288,16,50,182,228,62,111,173,105,49,9,80,79,548
1735,Anthony Ireland,SO,2011-12,G,Loyola Marymount,WCC,34,1241,190,432,140,284,50,148,118,153,35,96,131,168,58,0,104,68,548
1736,Mike James,SR,2011-12,G,Lamar,Southland,32,995,211,466,172,346,39,120,87,108,30,72,102,63,50,4,66,67,548
1737,Tiwian Kendley,SR,2017-18,G,Morgan State,MEAC,21,692,173,382,141,265,32,117,170,226,26,58,84,46,45,7,75,59,548
1738,Denzel Livingston,JR,2013-14,G,Incarnate Word,Southland,27,888,174,349,120,212,54,137,146,189,40,133,173,102,68,38,73,57,548
1739,Dejounte Murray,FR,2015-16,G,Washington,Pac-12,34,1139,202,486,168,368,34,118,110,166,48,155,203,151,62,10,110,90,548
1740,Tylor Ongwae,SR,2014-15,F,Louisiana-Monroe,Sun Belt,38,1347,198,485,173,382,25,103,127,152,93,159,252,110,37,11,93,82,548
1741,Wesley Person,JR,2016-17,G,Troy,Sun Belt,37,1160,164,378,70,143,94,235,126,154,20,76,96,58,21,2,49,50,548
1742,Kassius Robertson,JR,2016-17,G,Canisius,MAAC,34,1135,178,398,80,159,98,239,94,117,30,77,107,82,30,5,53,52,548
1743,Clarence Sanders,SR,2006-07,G,Mississippi,SEC,34,1058,206,486,110,224,96,262,40,51,30,55,85,51,41,15,47,59,548
1744,Dyami Starks,SO,2012-13,G,Bryant,NEC,31,1031,193,429,98,196,95,233,67,79,18,70,88,49,16,5,69,58,548
1745,Ricky Tarrant,SO,2012-13,G,Tulane,CUSA,35,1237,155,418,84,199,71,219,167,206,19,78,97,125,47,2,89,80,548
1746,Rashawn Thomas,JR,2015-16,F,Texas A&M-Corpus Christi,Southland,33,870,206,373,202,357,4,16,132,191,95,170,265,35,31,75,103,129,548
1747,Jake Toolson,JR,2018-19,G,Utah Valley,WAC,35,1164,188,350,119,196,69,154,103,121,31,125,156,80,18,7,83,59,548
1750,Nic Wise,JR,2008-09,G,Arizona,Pac-10,35,1273,177,392,111,233,66,159,128,151,13,75,88,160,52,3,101,86,548
1751,Francis Alonso,JR,2017-18,G,North Carolina-Greensboro,Southern,35,1026,175,425,64,148,111,277,86,99,16,67,83,103,36,2,87,82,547
1752,Nick Barbour,SO,2009-10,G,High Point,Big South,29,816,171,402,98,220,73,182,132,173,21,68,89,31,37,9,72,81,547
1753,AJ Brodeur,JR,2018-19,F,Pennsylvania,Ivy,31,1007,224,424,208,377,16,47,83,144,63,194,257,113,30,41,84,74,547
1754,Anthony Brown,SR,2014-15,G,Stanford,Pac-12,37,1320,176,408,97,229,79,179,116,146,42,214,256,94,28,7,72,78,547
1755,Luguentz Dort,FR,2018-19,G,Arizona State,Pac-12,34,1072,174,430,120,254,54,176,145,207,44,101,145,79,52,7,99,102,547
1756,Alex Franklin,SR,2009-10,F,Siena,MAAC,34,1117,191,344,191,344,0,0,165,247,93,184,277,46,47,30,81,76,547
1757,Kevin Hamilton,SR,2005-06,G,Holy Cross,Patriot,31,1120,160,420,97,230,63,190,164,211,41,155,196,108,102,14,118,82,547
1758,Zach Jackson,JR,2017-18,G,Omaha,Summit,31,986,192,367,150,269,42,98,121,147,47,150,197,29,35,12,68,71,547
1759,Tre Kelley,SR,2006-07,G,South Carolina,SEC,29,1064,198,454,143,297,55,157,96,120,13,61,74,149,26,7,83,66,547
1760,Tanner Leissner,JR,2016-17,F,New Hampshire,AEC,32,1102,185,394,164,321,21,73,156,188,73,148,221,57,15,10,56,84,547
1761,J.R. Lynch,SR,2018-19,G,Hartford,AEC,33,1253,176,388,107,214,69,174,126,150,21,102,123,126,70,4,65,78,547
1762,Rodney McGruder,SR,2012-13,G,Kansas State,Big 12,35,1171,204,462,153,310,51,152,88,117,74,114,188,71,44,9,58,54,547
1763,Isaiah Miller,SO,2018-19,G,North Carolina-Greensboro,Southern,36,1002,230,448,208,370,22,78,65,117,54,108,162,75,103,10,60,73,547
1764,Elijah Millsap,JR,2009-10,G,Alabama-Birmingham,CUSA,34,1124,182,418,163,339,19,79,164,236,92,232,324,60,56,11,118,111,547
1765,Stan Okoye,JR,2011-12,F,Virginia Military Institute,Big South,32,924,200,385,183,321,17,64,130,194,59,172,231,64,47,22,87,88,547
1766,Ahmaad Rorie,SO,2016-17,G,Montana,Big Sky,31,1007,192,428,129,264,63,164,100,120,25,84,109,97,26,7,47,66,547
1767,Martin Samarco,JR,2005-06,F,Bowling Green State,MAC,29,1035,175,418,75,199,100,219,97,113,34,85,119,36,27,2,68,70,547
1768,Chad Tomko,SR,2010-11,G,North Carolina-Wilmington,CAA,31,1132,190,459,110,243,80,216,87,107,18,164,182,132,58,8,100,60,547
1769,Marcus Tyus,SR,2016-17,G,Omaha,Summit,32,885,171,355,99,194,72,161,133,163,19,77,96,55,50,3,76,90,547
1772,Marcus Walker,JR,2007-08,G,Colorado State,MWC,32,1069,206,467,148,272,58,195,77,100,16,76,92,84,35,3,72,75,547
1773,Ray Barbosa,SR,2007-08,G,Maryland-Baltimore County,AEC,33,1104,179,420,93,189,86,231,102,122,27,108,135,70,29,3,56,65,546
1774,Bradley Beal,FR,2011-12,G,Florida,SEC,37,1267,175,393,112,207,63,186,133,173,50,199,249,83,51,31,79,76,546
1775,Bobby Brown,SR,2006-07,G,Cal State Fullerton,Big West,27,933,188,402,108,196,80,206,90,114,16,56,72,138,35,3,96,64,546
1776,Stevie Browning,SR,2016-17,G,Marshall,CUSA,34,1084,204,449,134,272,70,177,68,83,30,111,141,112,38,7,57,61,546
1777,Russell Carter,SR,2006-07,G,Notre Dame,Big East,32,974,191,443,107,230,84,213,80,112,40,117,157,59,51,11,69,70,546
1778,Wes Channels,JR,2008-09,G,Austin Peay,OVC,33,1085,173,412,94,209,79,203,121,156,29,95,124,103,42,2,100,88,546
1779,Patrick Christopher,SR,2009-10,G,University of California,Pac-10,35,1209,204,457,146,285,58,172,80,93,50,140,190,71,56,3,50,72,546
1780,LaceDarius Dunn,SR,2010-11,G,Baylor,Big 12,28,987,169,425,80,176,89,249,119,144,22,80,102,60,39,1,100,67,546
1781,James Feldeine,SR,2009-10,G,Quinnipiac,NEC,33,1070,197,463,159,352,38,111,114,143,44,148,192,81,47,6,84,73,546
1782,Anthony Fisher,SR,2007-08,G,Tennessee Tech,OVC,32,1063,157,370,110,210,47,160,185,243,18,80,98,114,48,1,108,90,546
1783,Juan'ya Green,SO,2012-13,G,Niagara,MAAC,33,1253,176,438,120,269,56,169,138,171,23,108,131,163,63,14,89,55,546
1784,Ricky Harris,JR,2008-09,G,Massachusetts,A-10,30,973,173,416,86,191,87,225,113,143,11,75,86,45,40,5,78,58,546
1785,Kenny Hasbrouck,JR,2007-08,G,Siena,MAAC,34,1074,199,450,143,306,56,144,92,128,33,80,113,76,77,6,61,74,546
1786,Jalen Hayes,SR,2017-18,F,Oakland,Horizon,29,1036,212,404,207,381,5,23,117,141,68,167,235,57,29,25,70,93,546
1787,Jelani Hewitt,SR,2014-15,G,Georgia Southern,Sun Belt,31,1087,149,424,60,158,89,266,159,197,31,99,130,114,77,10,80,57,546
1788,Anthony Johnson,SR,2009-10,F,Fairfield,MAAC,34,1039,208,404,208,401,0,3,130,207,158,176,334,17,41,82,63,103,546
1789,Mark Lyons,SR,2012-13,G,Arizona,Pac-12,35,1062,177,407,110,206,67,201,125,146,8,60,68,99,38,2,95,86,546
1790,J.P. Macura,JR,2016-17,G,Xavier,Big East,38,1272,179,420,115,232,64,188,124,158,50,117,167,110,54,8,77,90,546
1791,Randolph Morris,JR,2006-07,C,Kentucky,SEC,34,937,202,341,202,341,0,0,142,208,67,197,264,37,26,70,74,80,546
1794,Keiton Page,SR,2011-12,G,Oklahoma State,Big 12,32,1139,164,395,61,128,103,267,115,135,2,55,57,71,48,0,51,78,546
1795,T.J. Price,SR,2014-15,G,Western Kentucky,CUSA,32,1069,175,395,94,199,81,196,115,141,21,150,171,127,30,2,82,86,546
1796,Rodney Pryor,JR,2014-15,G,Robert Morris,NEC,35,1028,201,418,120,229,81,189,63,84,41,123,164,62,41,11,50,79,546
1797,Jordan Theodore,SR,2011-12,G,Seton Hall,Big East,34,1227,176,452,132,314,44,138,150,182,28,78,106,226,61,2,99,67,546
1798,Will Thomas,SR,2007-08,F,George Mason,CAA,34,1212,208,324,207,323,1,1,129,192,85,268,353,67,31,18,52,60,546
1799,De'Angelo Alexander,JR,2005-06,G,Charlotte,A-10,32,1111,181,447,85,223,96,224,87,119,88,107,195,59,35,10,52,63,545
1800,Jarrell Brown,SR,2007-08,G,Army,Patriot,30,1091,190,449,89,197,101,252,64,80,16,102,118,58,48,2,51,49,545
1801,Justin Cobbs,SR,2013-14,G,University of California,Pac-12,35,1206,185,397,153,301,32,96,143,175,17,85,102,204,29,3,85,64,545
1802,D.J. Cooper,JR,2011-12,G,Ohio,MAC,37,1199,162,465,87,221,75,244,146,196,28,109,137,211,85,3,106,51,545
1803,Dwayne Davis,SR,2012-13,F,Southern Mississippi,CUSA,34,1026,193,395,134,252,59,143,100,127,21,132,153,87,39,6,114,91,545
1804,James Ennis,SR,2012-13,G,Long Beach State,Big West,33,1093,182,371,127,217,55,154,126,151,65,156,221,70,58,43,99,75,545
1805,Buddy Hield,SO,2013-14,G,Oklahoma,Big 12,33,1059,196,440,106,207,90,233,63,84,58,88,146,62,46,5,60,72,545
1806,Kris Jenkins,JR,2015-16,F,Villanova,Big East,40,1134,179,390,79,131,100,259,87,103,20,136,156,87,32,16,52,103,545
1807,Carl Jones,SO,2010-11,G,Saint Joseph's,A-10,32,1086,163,396,109,250,54,146,165,221,13,71,84,110,36,2,78,57,545
1808,Jaron Jones,SR,2011-12,G,Eastern Kentucky,OVC,32,1085,187,352,163,288,24,64,147,190,55,87,142,59,46,8,60,85,545
1809,Walt Lemon ,JR,2012-13,G,Bradley,MVC,35,1200,201,446,166,340,35,106,108,142,19,128,147,133,75,14,129,99,545
1810,Robert Merritt,SR,2005-06,F,Samford,OVC,31,1159,180,386,60,134,120,252,65,80,29,131,160,53,33,2,58,49,545
1811,Jaylen Nowell,FR,2017-18,G,Washington,Pac-12,34,1106,203,450,164,339,39,111,100,125,33,102,135,92,36,9,85,96,545
1812,Trent Plaisted,JR,2007-08,F,Brigham Young,MWC,35,958,202,373,202,373,0,0,141,260,75,194,269,54,15,34,84,82,545
1813,Richard Roby,SR,2007-08,G,Colorado,Big 12,32,1110,189,396,142,273,47,123,120,157,58,156,214,66,33,31,107,104,545
1816,Brandan Wright,FR,2006-07,F,North Carolina,ACC,37,1013,228,353,228,353,0,0,89,157,77,152,229,37,36,65,59,55,545
1817,Damen Bell-Holter,SR,2012-13,F,Oral Roberts,Southland,35,1106,190,371,185,353,5,18,159,211,117,211,328,42,19,47,71,103,544
1818,Leon Buchanan,SR,2008-09,F,Morehead State,OVC,36,1242,177,343,174,339,3,4,187,233,107,120,227,37,27,12,80,83,544
1819,Cleanthony Early,JR,2012-13,F,Wichita State,MVC,39,979,184,404,137,256,47,148,129,163,89,123,212,23,29,35,61,100,544
1820,Michael Ertel,SO,2018-19,G,Louisiana-Monroe,Sun Belt,35,1272,191,436,111,256,80,180,82,91,13,93,106,99,23,5,44,56,544
1821,Austin Freeman,JR,2009-10,G,Georgetown,Big East,33,1135,201,383,142,250,59,133,83,97,31,86,117,80,30,7,63,61,544
1822,Treveon Graham,SO,2012-13,G,Virginia Commonwealth,A-10,36,995,186,413,134,271,52,142,120,164,99,110,209,56,32,5,56,81,544
1823,Tyler Hall,JR,2017-18,G,Montana State,Big Sky,31,995,174,428,75,162,99,266,97,107,23,93,116,86,25,12,56,53,544
1824,D'Angelo Harrison,FR,2011-12,G,St. John's (NY),Big East,32,1130,158,421,82,214,76,207,152,189,41,83,124,66,52,8,69,94,544
1825,Brad Jones,JR,2006-07,G,Wyoming,MWC,30,1113,157,396,125,293,32,103,198,253,40,113,153,135,45,2,130,90,544
1826,Chavaughn Lewis,JR,2013-14,G,Marist,MAAC,31,1073,185,465,157,374,28,91,146,196,22,134,156,88,60,11,98,89,544
1827,Kelvin Lewis,SR,2009-10,G,Houston,CUSA,35,1278,183,443,81,186,102,257,76,97,38,102,140,41,63,10,24,75,544
1828,Kelan Martin,JR,2016-17,F,Butler,Big East,34,977,180,421,116,237,64,184,120,153,34,162,196,40,23,14,66,74,544
1829,Drew McDonald,JR,2017-18,F,Northern Kentucky,Horizon,32,979,196,422,141,259,55,163,97,121,62,246,308,72,16,16,70,74,544
1830,Darren Moore,SR,2010-11,G,UC-Irvine,Big West,32,979,169,337,127,219,42,118,164,223,52,137,189,55,58,5,81,101,544
1831,Juwan Morgan,SR,2018-19,F,Indiana,Big Ten,35,1045,215,385,189,297,26,88,88,136,88,199,287,65,41,54,68,100,544
1832,Patrick Patterson,JR,2009-10,F,Kentucky,SEC,38,1255,215,374,191,305,24,69,90,130,116,167,283,36,27,51,41,61,544
1833,Kyle Roemer,SR,2009-10,F,Colgate,Patriot,29,999,192,447,116,241,76,206,84,106,39,125,164,40,43,6,79,75,544
1834,Alex Rosenberg,JR,2013-14,F,Columbia,Ivy,34,984,133,308,82,190,51,118,227,276,39,86,125,45,24,3,55,71,544
1835,Carlos Taylor,SR,2007-08,G,Montana State,Big Sky,30,887,184,402,124,251,60,151,116,144,21,93,114,63,28,7,75,85,544
1836,Brandon Triche,SR,2012-13,G,Syracuse,Big East,40,1348,185,445,136,275,49,170,125,168,57,79,136,144,51,5,109,86,544
1837,Kendall Williams,SR,2013-14,G,New Mexico,MWC,34,1200,151,351,88,189,63,162,179,226,25,96,121,168,53,2,68,61,544
1838,A.J. Abrams,SO,2006-07,G,Texas,Big 12,35,1242,175,441,55,157,120,284,73,79,25,61,86,52,46,4,48,63,543
1839,Hassan Adams,SR,2005-06,G,Arizona,Pac-10,31,1031,234,490,217,425,17,65,58,95,67,88,155,90,82,14,69,60,543
1840,Deandre Burnett,JR,2016-17,G,Mississippi,SEC,33,989,139,391,66,197,73,194,192,218,15,55,70,104,34,6,94,60,543
1841,Xavier Cooks,JR,2016-17,G,Winthrop,Big South,33,956,196,402,158,293,38,109,113,162,53,247,300,92,29,56,95,87,543
1842,Alpha Diallo,JR,2018-19,G,Providence,Big East,34,1205,176,419,136,299,40,120,151,224,88,188,276,106,56,17,91,87,543
1843,Fuquan Edwin,JR,2012-13,G,Seton Hall,Big East,33,1067,190,431,127,278,63,153,100,148,46,145,191,63,79,17,84,101,543
1844,Issiah Grayson,SR,2013-14,G,Cal State Bakersfield,WAC,32,1017,171,341,100,195,71,146,130,160,21,69,90,124,46,1,90,80,543
1845,Chris Hass,JR,2014-15,G,Bucknell,Patriot,34,1007,181,423,99,215,82,208,99,119,20,93,113,38,17,11,51,58,543
1846,John Holland,SO,2008-09,F,Boston University,AEC,30,1065,185,399,105,197,80,202,93,121,67,99,166,32,53,10,52,70,543
1847,Scotty Hopson,JR,2010-11,G,Tennessee,SEC,32,937,188,416,135,275,53,141,114,155,28,79,107,41,26,5,89,63,543
1848,Zach LeDay,JR,2015-16,F,Virginia Tech,ACC,35,1078,181,379,160,320,21,59,160,210,102,173,275,48,27,58,57,100,543
1849,Zach LeDay,SR,2016-17,F,Virginia Tech,ACC,32,945,183,340,172,300,11,40,166,215,82,160,242,40,19,33,60,90,543
1850,Preston Parks,FR,2016-17,G,Citadel,Southern,31,841,185,456,108,222,77,234,96,116,30,64,94,116,60,5,78,62,543
1851,Sebastian Saiz,SR,2016-17,F,Mississippi,SEC,36,1200,181,386,160,313,21,73,160,215,122,287,409,36,36,38,80,116,543
1852,Jovonni Shuler,SR,2010-11,G,Savannah State,Ind,30,1041,173,433,96,213,77,220,120,163,38,117,155,59,40,11,80,74,543
1853,Devin Watson,SR,2018-19,G,San Diego State,MWC,34,1155,168,421,79,188,89,233,118,158,13,93,106,142,29,0,89,44,543
1854,Keoni Watson,SR,2006-07,G,Idaho,WAC,30,941,191,435,121,262,70,173,91,117,16,74,90,65,37,1,100,82,543
1855,Jalen Adams,JR,2017-18,G,Connecticut,AAC,30,1144,208,484,160,336,48,148,78,98,26,101,127,141,46,10,87,46,542
1858,Aaron Bacote,SO,2013-14,G,Old Dominion,CUSA,35,1033,163,407,107,249,56,158,160,205,16,89,105,102,26,5,100,67,542
1859,Alex Barnett,SR,2008-09,F,Dartmouth,Ivy,28,956,194,439,140,307,54,132,100,122,35,121,156,54,36,33,63,53,542
1860,Aaron Calixte,SR,2017-18,G,Maine,AEC,32,1062,187,393,126,235,61,158,107,119,15,85,100,102,28,4,121,74,542
1861,Rakeem Christmas,SR,2014-15,F,Syracuse,ACC,31,1064,203,368,203,367,0,1,136,191,97,185,282,47,29,78,78,105,542
1862,Chris Cokley,SR,2017-18,F,Alabama-Birmingham,CUSA,32,870,219,376,219,374,0,2,104,127,100,176,276,49,18,13,47,52,542
1863,Brandon Cotton,SR,2006-07,G,Detroit Mercy,Horizon,30,991,206,435,164,326,42,109,88,130,12,41,53,53,26,0,62,31,542
1864,Quinton Day,SR,2006-07,G,Missouri-Kansas City,Mid-Cont,32,1180,182,456,90,214,92,242,86,109,13,98,111,131,54,1,109,50,542
1865,Kris Dunn,JR,2015-16,G,Providence,Big East,33,1088,184,411,142,298,42,113,132,190,36,140,176,206,82,20,116,93,542
1866,KJ Feagin,JR,2017-18,G,Santa Clara,WCC,31,1085,201,454,140,290,61,164,79,91,12,53,65,125,26,3,72,69,542
1867,Daniel Gafford,SO,2018-19,F,Arkansas,SEC,32,919,214,324,214,324,0,0,114,193,91,186,277,23,30,65,76,88,542
1868,Trey Gilder,SR,2007-08,F,Northwestern State,Southland,33,887,189,394,172,324,17,70,147,192,76,128,204,63,39,22,89,69,542
1869,David Huertas,JR,2008-09,G,Mississippi,SEC,30,951,166,398,89,181,77,217,133,165,38,98,136,68,27,6,71,66,542
1870,JaJuan Johnson,JR,2009-10,F,Purdue,Big Ten,35,1093,192,379,192,375,0,4,158,220,82,168,250,26,30,72,63,71,542
1871,Matt Lewis,SO,2018-19,G,James Madison,CAA,33,1200,168,436,108,252,60,184,146,180,31,107,138,99,30,12,87,66,542
1872,E.C. Matthews,SO,2014-15,G,Rhode Island,A-10,32,1052,172,420,104,211,68,209,130,177,34,112,146,63,24,17,115,68,542
1873,Demetri McCamey,JR,2009-10,G,Illinois,Big Ten,36,1241,191,421,135,257,56,164,104,147,17,112,129,254,53,5,123,90,542
1874,Carlos Medlock,SR,2009-10,G,Eastern Michigan,MAC,32,1125,147,382,72,158,75,224,173,215,19,93,112,121,50,2,111,93,542
1875,Takal Molson,SO,2018-19,G,Canisius,MAAC,32,1045,176,417,121,212,55,205,135,179,57,117,174,63,41,9,82,80,542
1876,Nijal Pearson,JR,2018-19,G,Texas State,Sun Belt,33,1097,192,456,112,249,80,207,78,113,49,120,169,46,45,6,59,58,542
1877,Jeff Roberson,SR,2017-18,F,Vanderbilt,SEC,32,1102,164,343,102,190,62,153,152,178,61,167,228,49,28,10,49,91,542
1880,Desi Rodriguez,SR,2017-18,F,Seton Hall,Big East,31,939,204,410,148,260,56,150,78,106,33,116,149,63,32,15,62,74,542
1881,Jaaron Simmons,SO,2015-16,G,Ohio,MAC,35,1276,172,370,140,292,32,78,166,213,9,115,124,275,29,0,136,108,542
1882,Ryan Welage,JR,2017-18,F,San Jose State,MWC,30,1039,191,414,131,274,60,140,100,114,26,135,161,42,17,5,54,43,542
1883,Isiah Williams,SR,2011-12,G,Utah Valley,GWC,33,1101,185,479,102,227,83,252,89,105,13,78,91,73,28,4,76,49,542
1884,Leon Williams,SR,2007-08,F,Ohio,MAC,33,1009,180,293,179,292,1,1,181,247,145,180,325,41,47,23,80,93,542
1885,Matt Williams,SR,2016-17,G,Central Florida,AAC,36,1315,178,455,52,127,126,328,60,74,16,138,154,69,25,1,65,64,542
1886,Jamaal Franklin,JR,2012-13,G,San Diego State,MWC,32,1058,165,401,125,254,40,147,171,219,56,248,304,105,51,26,110,83,541
1887,Ashton Gibbs,SR,2011-12,G,Pittsburgh,Big East,37,1270,183,479,102,244,81,235,94,110,19,65,84,77,19,2,61,38,541
1888,DeAndre Hall,SR,2009-10,G,Texas Southern,SWAC,33,1104,220,438,206,399,14,39,87,137,56,127,183,87,63,15,107,83,541
1889,Demonte Harper,SR,2010-11,G,Morehead State,OVC,35,1180,198,459,142,309,56,150,89,133,45,129,174,120,54,10,136,99,541
1890,Cameron Jones,JR,2009-10,G,Northern Arizona,Big Sky,28,986,203,404,170,326,33,78,102,138,22,108,130,78,35,1,86,50,541
1891,Kaleo Kina,SR,2008-09,G,Navy,Patriot,30,978,185,458,150,315,35,143,136,187,22,146,168,113,41,4,93,77,541
1892,Antoine Mason,SO,2012-13,G,Niagara,MAAC,29,1053,167,379,133,271,34,108,173,218,34,84,118,43,33,7,64,69,541
1893,Grant Maxey,JR,2008-09,F,Jackson State,SWAC,33,1026,198,435,156,309,42,126,103,132,69,151,220,76,52,29,99,97,541
1894,Jalen McDaniels,SO,2018-19,F,San Diego State,MWC,34,1055,212,455,188,380,24,75,93,127,67,214,281,72,38,16,82,100,541
1895,Cleveland Melvin,SO,2011-12,F,DePaul,Big East,31,995,219,489,203,419,16,70,87,137,76,153,229,24,25,34,69,59,541
1896,Ashton Moore,SR,2014-15,G,Citadel,Southern,30,1129,173,420,94,214,79,206,116,135,15,82,97,109,29,5,102,44,541
1897,Stuckey Mosley,SR,2018-19,G,James Madison,CAA,33,1158,194,487,99,228,95,259,58,81,22,103,125,75,37,3,57,74,541
1898,Xavier Munford,SR,2013-14,G,Rhode Island,A-10,32,1139,184,458,122,268,62,190,111,157,20,108,128,78,36,13,88,63,541
1899,Steve Novak,SR,2005-06,F,Marquette,Big East,31,1047,173,363,52,104,121,259,74,76,34,149,183,39,18,4,32,64,541
1902,Royce Parran,JR,2005-06,G,Chicago State,Mid-Cont,30,1040,166,402,98,229,68,173,141,185,20,82,102,116,57,1,83,77,541
1903,Dalton Pepper,SR,2013-14,G,Temple,AAC,31,1171,198,457,114,233,84,224,61,70,42,117,159,74,32,6,52,54,541
1904,Brion Rush,SR,2005-06,G,Grambling,SWAC,21,730,189,462,135,289,54,173,109,131,29,117,146,71,48,1,73,50,541
1905,Antwan Scott,SR,2015-16,G,Colorado State,MWC,33,1007,173,404,77,173,96,231,99,130,9,133,142,70,21,2,58,85,541
1906,Trevis Simpson,JR,2012-13,G,North Carolina-Greensboro,Southern,29,858,187,461,123,273,64,188,103,129,27,96,123,40,19,3,58,78,541
1907,Isaiah Thomas,FR,2008-09,G,Washington,Pac-10,35,993,180,431,141,297,39,134,142,207,24,82,106,91,38,2,92,66,541
1908,Jeremy Wise,FR,2006-07,G,Southern Mississippi,CUSA,31,1034,176,439,123,291,53,148,136,163,13,93,106,94,27,9,114,91,541
1909,Josh Ajayi,JR,2018-19,F,South Alabama,Sun Belt,33,1030,197,352,181,316,16,36,130,185,74,170,244,52,22,29,87,88,540
1910,Davis Baker,JR,2008-09,G,Southern Utah,Summit,31,1085,200,426,153,311,47,115,93,106,26,114,140,42,30,5,72,55,540
1911,Jordan Barnes,SO,2017-18,G,Indiana State,MVC,31,1044,168,405,51,128,117,277,87,102,10,111,121,113,37,2,86,78,540
1912,Brett Bisping,JR,2015-16,F,Siena,MAAC,34,1129,180,389,140,275,40,114,140,176,79,275,354,50,25,15,80,105,540
1913,Wes Channels,SR,2009-10,G,Austin Peay,OVC,32,1129,172,416,101,255,71,161,125,173,35,104,139,94,45,6,92,85,540
1914,Zachary Hamilton,SR,2017-18,F,Prairie View,SWAC,34,936,181,453,92,215,89,238,89,113,35,110,145,43,32,9,57,94,540
1915,Jalen Hayes,JR,2016-17,F,Oakland,Horizon,34,1025,217,397,212,384,5,13,101,142,82,191,273,54,39,25,55,105,540
1916,Mac Hopson,JR,2008-09,G,Idaho,WAC,33,1133,183,397,137,290,46,107,128,189,27,136,163,194,55,6,96,82,540
1917,Damion James,JR,2008-09,F,Texas,Big 12,35,1034,203,434,175,348,28,86,106,155,103,219,322,47,34,30,79,94,540
1918,Orlando Johnson,SO,2009-10,G,UC-Santa Barbara,Big West,30,939,176,366,130,250,46,116,142,202,56,106,162,69,21,17,81,72,540
1919,Jerome Jordan,SR,2009-10,C,Tulsa,CUSA,35,1043,184,335,184,335,0,0,172,250,84,233,317,44,16,82,79,98,540
1920,Joe Kilgore,SR,2017-18,G,Texas A&M-Corpus Christi,Southland,29,1019,183,451,146,343,37,108,137,173,28,135,163,96,52,18,86,60,540
1921,Elijah Mitrou-Long,SO,2016-17,G,Mount St. Mary's,NEC,36,1239,180,437,133,314,47,123,133,180,16,171,187,157,57,3,123,100,540
1924,Demetrius Nelson,SR,2008-09,F,Citadel,Southern,33,946,183,307,183,307,0,0,174,225,68,147,215,28,15,17,68,93,540
1925,Taurean Prince,SR,2015-16,F,Baylor,Big 12,34,1040,187,433,134,286,53,147,113,146,81,125,206,77,43,25,91,86,540
1926,Justin Sears,SO,2013-14,F,Yale,Ivy,32,978,183,354,179,342,4,12,170,244,91,129,220,46,39,62,70,83,540
1927,DeShawn Sims,JR,2008-09,F,Michigan,Big Ten,35,1075,224,444,198,362,26,82,66,93,86,152,238,26,40,27,46,76,540
1928,Adam Smith,SR,2015-16,C,Georgia Tech,ACC,36,1098,185,455,76,192,109,263,61,76,12,70,82,69,15,1,44,57,540
1929,Ben Smith,JR,2008-09,G,Jacksonville,A-Sun,32,1160,168,399,102,220,66,179,138,175,23,82,105,128,70,0,74,54,540
1930,Mark Tyndale,SR,2007-08,G,Temple,A-10,34,1272,178,365,146,278,32,87,152,214,45,200,245,145,54,21,117,74,540
1931,Ryan Anderson,FR,2006-07,F,University of California,Pac-10,33,1096,189,397,131,245,58,152,103,129,79,190,269,16,22,18,47,91,539
1932,Shannon Bogues,JR,2017-18,G,Stephen F. Austin,Southland,35,842,201,398,157,273,44,125,93,117,24,61,85,48,46,6,49,40,539
1933,Clif Brown,SR,2006-07,F,Niagara,MAAC,33,1112,194,480,138,323,56,157,95,127,117,204,321,28,26,10,77,80,539
1934,Norris Cole,JR,2009-10,G,Cleveland State,Horizon,33,1127,185,428,147,317,38,111,131,164,14,77,91,146,61,3,91,81,539
1935,Jermaine Crumpton,JR,2016-17,F,Canisius,MAAC,34,967,195,397,138,264,57,133,92,128,65,88,153,45,33,11,68,86,539
1936,James Florence,FR,2006-07,G,Mercer,A-Sun,28,934,163,437,108,254,55,183,158,203,,,114,91,47,14,,,539
1937,Chris Fowler,SO,2013-14,G,Central Michigan,MAC,31,1026,184,370,158,302,26,68,145,212,18,77,95,163,60,1,87,93,539
1938,Corey Hawkins,JR,2013-14,G,UC-Davis,Big West,30,1014,171,385,133,267,38,118,159,210,21,114,135,89,44,11,60,65,539
1939,Leo Lyons,SR,2008-09,F,Missouri,Big 12,37,861,176,357,171,344,5,13,182,245,82,143,225,73,38,26,85,93,539
1940,Kyle McAlarney,SR,2008-09,G,Notre Dame,Big East,36,1329,177,437,53,144,124,293,61,69,6,87,93,124,23,3,68,52,539
1941,Josh Sharkey,JR,2018-19,G,Samford,Southern,33,1168,175,394,145,297,30,97,159,212,19,108,127,239,86,2,165,86,539
1942,Keifer Sykes,SO,2012-13,G,Green Bay,Horizon,34,1175,175,402,145,331,30,71,159,196,18,93,111,146,37,4,84,85,539
1943,Ameen Tanksley,SR,2015-16,G,Hofstra,CAA,34,1180,170,406,108,234,62,172,137,173,66,112,178,48,30,8,68,79,539
1944,Erving Walker,JR,2010-11,G,Florida,SEC,37,1212,153,372,74,167,79,205,154,198,18,91,109,125,41,0,87,56,539
1945,Julius Wells,SO,2009-10,F,James Madison,CAA,33,1211,182,470,91,212,91,258,84,120,24,143,167,74,30,2,106,68,539
1946,Tim Williams,JR,2015-16,F,New Mexico,MWC,32,1078,215,356,215,356,0,0,109,163,65,172,237,33,19,39,48,67,539
1947,Kent Bazemore,SR,2011-12,G,Old Dominion,CAA,35,1103,186,457,135,298,51,159,115,182,65,148,213,107,74,12,112,96,538
1948,Julius Brown,SR,2014-15,G,Toledo,MAC,33,1098,193,416,125,246,68,170,84,98,10,63,73,144,31,11,74,44,538
1949,Kareem Canty,FR,2013-14,G,Marshall,CUSA,33,1211,187,502,122,288,65,214,99,136,25,49,74,180,24,3,121,54,538
1950,Joe Crawford,SR,2007-08,G,Kentucky,SEC,30,1009,188,401,125,228,63,173,99,130,31,78,109,64,17,5,83,81,538
1951,Ross Cummings,JR,2018-19,G,Mercer,Southern,31,1032,162,379,61,126,101,253,113,141,12,79,91,59,16,2,70,50,538
1952,Chris Douglas-Roberts,SO,2006-07,G,Memphis,CUSA,35,930,194,357,175,299,19,58,131,179,37,83,120,61,39,16,66,76,538
1953,Alex Francis,JR,2012-13,F,Bryant,NEC,31,1083,211,371,211,363,0,8,116,192,92,175,267,56,23,5,105,75,538
1954,Louis Graham,SR,2007-08,F,Georgia Southern,Southern,32,841,192,400,175,356,17,44,137,186,67,149,216,19,52,54,81,102,538
1955,Alex Hamilton,SO,2013-14,G,Louisiana Tech,CUSA,37,1034,172,370,142,258,30,112,164,226,25,109,134,109,53,16,79,61,538
1956,Isaac Hamilton,JR,2015-16,G,UCLA,Pac-12,32,1129,206,436,146,277,60,159,66,82,31,104,135,106,33,2,76,69,538
1957,Cory Higgins,SO,2008-09,G,Colorado,Big 12,31,1146,165,347,133,258,32,89,176,212,18,149,167,80,59,11,87,77,538
1958,Quin Humphrey,JR,2005-06,G,Youngstown State,Horizon,28,1034,189,381,139,247,50,134,110,149,68,165,233,72,34,11,80,51,538
1959,Tyren Johnson,SR,2009-10,F,Louisiana,Sun Belt,30,1082,205,410,175,327,30,83,98,142,60,179,239,99,54,44,108,84,538
1960,Tyreke Key,SO,2018-19,G,Indiana State,MVC,31,1065,181,345,138,249,43,96,133,169,26,84,110,53,33,1,49,61,538
1961,Jordan Murphy,JR,2017-18,F,Minnesota,Big Ten,32,1019,202,385,191,350,11,35,123,176,129,232,361,45,39,32,83,81,538
1962,Sa'eed Nelson,SO,2017-18,G,American,Patriot,29,1074,191,431,163,335,28,96,128,188,25,79,104,147,52,5,109,77,538
1963,Charles Rhodes,SR,2007-08,F,Mississippi State,SEC,31,976,214,381,211,375,3,6,107,159,89,153,242,29,16,42,74,74,538
1966,Quinton Rose,JR,2018-19,G,Temple,AAC,33,1143,204,500,163,351,41,149,89,130,15,110,125,82,71,7,83,67,538
1967,Yuta Watanabe,SR,2017-18,G,George Washington,A-10,33,1207,193,442,137,288,56,154,96,119,42,158,200,52,26,54,51,50,538
1968,Cecil Williams,SR,2017-18,F,Central Michigan,MAC,36,1088,181,386,158,310,23,76,153,197,56,177,233,94,36,37,101,106,538
1969,Michael Williams,SR,2013-14,G,Cal State Fullerton,Big West,31,1073,184,441,113,243,71,198,99,139,19,109,128,76,28,6,67,74,538
1970,Jaylen Adams,SO,2015-16,G,St. Bonaventure,A-10,30,1125,150,337,66,145,84,192,153,175,23,87,110,150,40,9,82,80,537
1971,Raheem Appleby,SR,2014-15,G,Louisiana Tech,CUSA,36,1184,200,500,129,284,71,216,66,86,22,75,97,73,46,2,39,35,537
1972,Michael Bramos,SR,2008-09,F,Miami (OH),MAC,30,1057,173,430,102,231,71,199,120,144,15,109,124,51,29,33,60,54,537
1973,Darell Combs,SR,2016-17,G,IUPUI,Summit,32,1029,187,441,124,257,63,184,100,134,16,62,78,92,24,4,81,82,537
1974,Donte DiVincenzo,SO,2017-18,G,Villanova,Big East,40,1170,188,391,103,179,85,212,76,107,46,144,190,139,42,8,79,83,537
1975,Patricio Garino,SR,2015-16,G,George Washington,A-10,38,1217,203,398,145,263,58,135,73,106,52,109,161,56,52,31,72,98,537
1976,J.R. Giddens,SR,2007-08,G,New Mexico,MWC,33,1063,210,407,185,332,25,75,92,157,57,233,290,103,47,39,73,64,537
1977,Corey Hassan,SR,2009-10,F,Sacred Heart,NEC,28,962,187,435,97,201,90,234,73,105,63,149,212,58,39,1,77,56,537
1978,Fred Hunter,SR,2012-13,G,Nicholls State,Southland,27,861,186,328,170,270,16,58,149,225,89,131,220,57,48,8,64,72,537
1979,Christian Keeling,FR,2016-17,G,Charleston Southern,Big South,31,968,183,400,158,327,25,73,146,187,40,179,219,43,28,9,53,53,537
1980,Javon McCrea,SR,2013-14,F,Buffalo,MAC,29,937,202,360,201,358,1,2,132,198,112,174,286,64,44,65,70,92,537
1981,Michael Oguine,JR,2017-18,G,Montana,Big Sky,34,1096,177,384,131,255,46,129,137,186,73,115,188,67,48,18,45,95,537
1982,Jarelle Reischel,SR,2015-16,F,Eastern Kentucky,OVC,30,941,165,339,125,234,40,105,167,213,38,166,204,96,50,13,124,88,537
1983,Kassius Robertson,SR,2017-18,G,Missouri,SEC,33,1187,158,374,53,131,105,243,116,146,9,90,99,77,32,2,77,57,537
1984,D.J. Seeley,JR,2011-12,G,Cal State Fullerton,Big West,31,966,169,385,103,233,66,152,133,182,61,109,170,57,45,6,89,92,537
1985,Iman Shumpert,JR,2010-11,G,Georgia Tech,ACC,31,992,177,436,135,285,42,151,141,175,53,130,183,108,85,6,72,86,537
1988,Chase Tapley,JR,2011-12,G,San Diego State,MWC,34,1157,200,440,123,262,77,178,60,83,22,124,146,77,60,15,55,58,537
1989,Kibwe Trim,SR,2005-06,F,Sacred Heart,NEC,28,913,194,314,194,314,0,0,149,221,99,142,241,18,22,15,76,90,537
1990,Davauhnte Turner,SR,2018-19,G,Saint Peter's,MAAC,32,1148,183,445,112,243,71,202,100,126,33,73,106,77,33,9,80,54,537
1991,Jaylin Walker,SO,2016-17,G,Kent State,MAC,34,1055,185,468,97,204,88,264,79,101,51,97,148,31,26,0,69,58,537
1992,James White,SR,2005-06,F,Cincinnati,Big East,33,1104,177,363,128,232,49,131,134,160,42,125,167,67,36,28,77,89,537
1993,Elijah Wilson,FR,2013-14,G,Coastal Carolina,Big South,34,1107,200,464,149,297,51,167,86,123,41,99,140,30,32,8,46,84,537
1994,Calvin Wooten,JR,2005-06,G,Oakland,Mid-Cont,28,930,188,441,93,198,95,243,66,83,11,58,69,65,49,4,76,62,537
1995,Dwayne Bacon,FR,2015-16,G,Florida State,ACC,34,979,197,441,165,327,32,114,110,154,46,151,197,50,33,1,74,73,536
1996,Shannon Bogues,SR,2018-19,G,Stephen F. Austin,Southland,30,1083,178,424,112,245,66,179,114,145,13,77,90,108,36,8,95,44,536
1997,Devin Carter,JR,2015-16,G,Arkansas State,Sun Belt,31,1110,183,400,95,189,88,211,82,117,30,105,135,60,22,10,56,86,536
1998,Mardy Collins,SR,2005-06,G,Temple,A-10,32,1212,202,468,160,331,42,137,90,151,46,104,150,127,89,6,65,71,536
1999,T.J. Cromer,JR,2015-16,G,East Tennessee State,Southern,36,1152,182,421,112,229,70,192,102,128,26,97,123,110,36,2,73,92,536
2000,Jimmer Fredette,SO,2008-09,G,Brigham Young,MWC,33,1090,184,383,132,247,52,136,116,137,18,80,98,135,50,3,85,43,536
2001,Jessie Govan,JR,2017-18,C,Georgetown,Big East,30,980,201,396,185,350,16,46,118,155,74,227,301,59,18,34,52,87,536
2002,Tra Holder,JR,2016-17,G,Arizona State,Pac-12,33,1175,169,390,123,265,46,125,152,197,38,83,121,106,29,1,66,68,536
2003,Pooh Jeter,SR,2005-06,G,Portland,WCC,29,1045,173,409,116,253,57,156,133,153,17,86,103,87,35,0,72,54,536
2004,Manu Lecomte,SR,2017-18,G,Baylor,Big 12,33,1124,162,403,71,164,91,239,121,136,7,65,72,122,22,0,71,60,536
2005,Shelvin Mack,SO,2009-10,G,Butler,Horizon,38,1173,192,423,120,239,72,184,80,109,20,122,142,115,52,5,79,71,536
2006,Brian Mills,SR,2010-11,F,Mercer,A-Sun,33,1011,195,428,176,359,19,69,127,176,69,130,199,41,31,16,75,107,536
2007,Jonathan Rodriguez,FR,2006-07,F,Campbell,A-Sun,31,1028,184,393,164,324,20,69,148,209,76,196,272,94,45,34,82,72,536
2010,Jared Sam,SR,2017-18,F,Southern,SWAC,33,1106,177,405,176,404,1,1,181,236,103,189,292,44,28,25,75,66,536
2011,Jon Severe,FR,2013-14,G,Fordham,A-10,31,1021,163,493,84,262,79,231,131,165,31,56,87,63,29,6,82,69,536
2012,DeShawn Sims,SR,2009-10,F,Michigan,Big Ten,32,1026,220,447,199,373,21,74,75,112,98,144,242,30,35,21,48,71,536
2013,Gary Trent Jr.,FR,2017-18,G,Duke,ACC,37,1253,177,427,80,186,97,241,85,97,31,126,157,52,43,5,38,62,536
2014,Darren White,JR,2011-12,G,Campbell,Big South,32,1025,197,379,152,260,45,119,97,147,57,118,175,67,29,34,84,80,536
2015,Booker Woodfox,SR,2008-09,G,Creighton,MVC,34,848,173,363,82,172,91,191,99,114,21,65,86,37,22,1,34,41,536
2016,Jaylen Adams,SR,2017-18,G,St. Bonaventure,A-10,28,1036,153,350,78,178,75,172,154,181,12,83,95,146,43,7,86,80,535
2017,Joel Berry,SO,2015-16,G,North Carolina,ACC,40,1228,185,413,115,227,70,186,95,109,25,108,133,150,58,9,61,89,535
2018,Roy Bright,SR,2007-08,F,Delaware State,MEAC,28,1014,195,458,117,238,78,220,67,83,36,113,149,18,20,17,38,73,535
2019,Mike Caffey,SR,2014-15,G,Long Beach State,Big West,33,1073,195,449,133,274,62,175,83,114,21,110,131,119,61,5,88,65,535
2020,Reggie Chamberlain,SR,2011-12,G,Missouri-Kansas City,Summit,31,1022,174,384,77,178,97,206,90,104,11,68,79,77,28,2,51,75,535
2021,Stephen Croone,JR,2014-15,G,Furman,Southern,31,992,155,346,100,188,55,158,170,226,26,119,145,80,51,6,75,78,535
2022,Ron Curry,SR,2015-16,G,James Madison,CAA,31,1035,167,378,95,184,72,194,129,173,13,114,127,112,31,12,46,63,535
2023,Terence Davis,SO,2016-17,G,Mississippi,SEC,36,911,200,415,151,268,49,147,86,119,51,139,190,63,50,18,74,114,535
2024,LaVonte Dority,SR,2013-14,G,Valparaiso,Horizon,34,1062,163,367,99,217,64,150,145,172,18,68,86,83,22,2,72,58,535
2025,Kellen Dunham,SR,2015-16,G,Butler,Big East,33,1069,166,379,79,176,87,203,116,138,15,67,82,50,22,3,50,55,535
2026,Anthony Goods,SR,2008-09,G,Stanford,Pac-10,33,1052,161,386,90,203,71,183,142,182,26,83,109,59,23,2,78,44,535
2027,Desharick Guidry,SR,2014-15,F,McNeese State,Southland,31,1092,195,400,158,301,37,99,108,151,135,211,346,51,40,20,66,86,535
2028,Armon Johnson,JR,2009-10,G,Nevada,WAC,34,1172,219,442,202,371,17,71,80,118,26,89,115,189,28,12,114,61,535
2029,Austin Kenon,JR,2009-10,G,Virginia Military Institute,Big South,29,908,161,415,81,173,80,242,133,158,35,53,88,105,41,3,73,70,535
2032,Egor Koulechov,SO,2015-16,G,Rice,CUSA,32,1101,175,420,95,186,80,234,105,122,48,176,224,42,28,6,45,69,535
2033,Jack Leasure,SO,2005-06,G,Coastal Carolina,Big South,30,1041,180,411,55,113,125,298,50,60,23,69,92,122,49,0,83,45,535
2034,Luke Maye,SR,2018-19,F,North Carolina,ACC,36,1111,198,460,162,335,36,125,103,133,92,285,377,84,23,20,71,93,535
2035,Egidijus Mockevicius,SR,2015-16,C,Evansville,MVC,34,1082,195,306,195,306,0,0,145,212,85,389,474,9,27,94,55,110,535
2036,Derick Nelson,JR,2007-08,F,Oakland,Summit,31,1050,176,395,157,336,19,59,164,257,102,128,230,48,54,2,87,81,535
2037,Tyrone Nelson,SO,2005-06,F,New Mexico State,WAC,30,987,189,343,189,342,0,1,157,208,97,164,261,48,48,14,99,88,535
2038,Rodney Pierce,SR,2009-10,G,Buffalo,MAC,29,985,188,458,131,297,57,161,102,126,16,82,98,94,43,6,68,65,535
2039,Gerald Robinson,SO,2008-09,G,Tennessee State,OVC,30,990,178,403,148,295,30,108,149,193,36,81,117,116,61,2,108,70,535
2040,Daniel Utomi,SO,2017-18,F,Akron,MAC,32,1104,175,389,87,170,88,219,97,126,33,137,170,60,30,9,67,74,535
2041,Drew Viney,SO,2009-10,F,Loyola Marymount,WCC,32,1103,184,415,121,267,63,148,104,127,48,178,226,60,37,38,65,84,535
2042,Jay Wright,SR,2016-17,G,Louisiana,Sun Belt,33,1137,181,404,130,254,51,150,122,170,20,62,82,129,65,11,79,69,535
2043,Brandon Young,JR,2012-13,G,DePaul,Big East,32,1008,180,411,149,312,31,99,144,194,27,80,107,146,49,5,86,55,535
2044,Ty-Shon Alexander,SO,2018-19,G,Creighton,Big East,34,1108,176,433,79,167,97,266,85,107,17,118,135,92,41,10,69,70,534
2045,James Batemon,JR,2017-18,G,Loyola Marymount,WCC,30,1050,167,350,124,240,43,110,157,196,32,77,109,139,35,1,87,82,534
2046,Martin Breunig,JR,2014-15,F,Montana,Big Sky,32,963,214,361,212,348,2,13,104,141,82,151,233,60,17,27,76,110,534
2047,Matthew Bryan-Amaning,SR,2010-11,F,Washington,Pac-10,35,986,215,394,215,393,0,1,104,168,105,176,281,24,37,54,57,100,534
2048,Bryant Crawford,SO,2016-17,G,Wake Forest,ACC,33,1049,169,386,115,230,54,156,142,172,11,115,126,182,49,9,76,93,534
2049,Matt Dickey,JR,2010-11,G,North Carolina-Asheville,Big South,34,1163,169,389,104,214,65,175,131,154,19,107,126,111,64,1,97,89,534
2050,Dontaye Draper,SR,2006-07,G,College of Charleston,Southern,33,1186,165,407,74,170,91,237,113,153,19,116,135,176,57,11,111,73,534
2051,Antonio Green,SO,2016-17,G,Texas-Rio Grande Valley,WAC,32,972,177,448,66,150,111,298,69,89,21,85,106,56,19,4,87,46,534
2052,Jhivvan Jackson,FR,2017-18,G,Texas-San Antonio,CUSA,29,745,174,404,97,195,77,209,109,142,9,85,94,52,30,2,70,70,534
2053,Kosta Koufos,FR,2007-08,F,Ohio State,Big Ten,37,1003,222,437,200,374,22,63,68,100,98,149,247,19,16,67,55,81,534
2054,Francois Lewis,SR,2018-19,F,Presbyterian,Big South,36,971,180,384,98,176,82,208,92,123,40,138,178,57,27,6,52,100,534
2055,Bryant McIntosh,JR,2016-17,G,Northwestern,Big Ten,36,1231,199,493,157,356,42,137,94,108,9,90,99,188,26,4,96,74,534
2056,Chimezie Metu,SO,2016-17,F,Southern California,Pac-12,36,1128,202,366,201,364,1,2,129,174,73,207,280,50,28,55,76,89,534
2057,Matt Mobley,SO,2014-15,G,Central Connecticut State,NEC,31,1147,171,428,97,221,74,207,118,156,15,71,86,57,26,6,83,64,534
2058,Marcus Paige,JR,2014-15,G,North Carolina,ACC,38,1263,172,416,78,178,94,238,96,111,14,96,110,170,65,8,73,62,534
2059,Alex Renfroe,SR,2008-09,G,Belmont,A-Sun,33,999,182,332,150,246,32,86,138,205,70,166,236,169,69,17,120,79,534
2060,Mike Rosario,SO,2009-10,G,Rutgers,Big East,32,1079,184,487,106,248,78,239,88,119,43,83,126,46,31,3,87,63,534
2061,Quincy Taylor,SR,2014-15,G,Longwood,Big South,31,1115,188,433,102,254,86,179,72,98,13,79,92,83,40,5,93,74,534
2062,Melo Trimble,SO,2015-16,G,Maryland,Big Ten,36,1183,159,388,101,204,58,184,158,182,11,119,130,175,45,6,96,68,534
2063,Seth Tuttle,SR,2014-15,F,Northern Iowa,MVC,35,1062,183,303,164,259,19,44,149,195,47,193,240,114,33,20,99,75,534
2064,Averyl Ugba,SR,2017-18,F,Austin Peay,OVC,34,1020,202,368,186,324,16,44,114,170,101,172,273,34,16,36,77,97,534
2065,Ben Uzoh,SR,2009-10,G,Tulsa,CUSA,35,1202,184,403,135,260,49,143,117,153,34,129,163,163,34,26,80,60,534
2066,Quinndary Weatherspoon,JR,2017-18,G,Mississippi State,SEC,37,1162,187,386,145,252,42,134,118,153,56,166,222,123,52,12,99,86,534
2067,Akwasi Yeboah,JR,2018-19,G,Stony Brook,AEC,32,1019,183,443,117,234,66,209,102,130,52,193,245,46,28,15,82,82,534
2068,Antonio Blakeney,SO,2016-17,G,Louisiana State,SEC,31,1018,194,424,141,276,53,148,92,127,32,117,149,54,21,3,64,49,533
2069,Chris Flemmings,JR,2015-16,G,North Carolina-Wilmington,CAA,33,1052,180,353,123,196,57,157,116,143,44,148,192,52,45,23,44,68,533
2070,Ashton Gibbs,SO,2009-10,G,Pittsburgh,Big East,34,1178,159,401,81,202,78,199,137,155,14,82,96,62,26,3,41,40,533
2071,Treveon Graham,SR,2014-15,G,Virginia Commonwealth,A-10,33,970,172,402,108,234,64,168,125,181,73,162,235,53,20,9,38,67,533
2074,Kevon Harris,JR,2018-19,G,Stephen F. Austin,Southland,30,1045,176,338,126,206,50,132,131,178,52,142,194,60,30,15,87,73,533
2075,Ria'n Holland,JR,2016-17,G,Mercer,Southern,31,975,177,405,100,201,77,204,102,121,24,78,102,59,32,7,44,72,533
2076,Frank Howard,JR,2017-18,G,Syracuse,ACC,37,1422,187,497,120,292,67,205,92,128,19,110,129,175,68,10,126,96,533
2077,Robert Jarvis,SR,2008-09,G,Oral Roberts,Summit,31,1086,181,467,97,216,84,251,87,112,11,69,80,63,29,2,80,63,533
2078,Tyler Kalinoski,SR,2014-15,G,Davidson,A-10,32,1112,191,410,100,195,91,215,60,76,48,133,181,130,39,13,44,85,533
2079,Dior Lowhorn,SR,2009-10,F,San Francisco,WCC,29,835,189,402,167,324,22,78,133,164,65,127,192,17,19,14,59,63,533
2080,Jordan Lyons,JR,2018-19,G,Furman,Southern,33,1084,185,467,80,164,105,303,58,76,14,60,74,75,39,2,76,38,533
2081,Chimezie Metu,JR,2017-18,F,Southern California,Pac-12,34,1053,205,392,193,352,12,40,111,152,64,189,253,53,27,59,68,87,533
2082,Artsiom Parakhouski,JR,2008-09,C,Radford,Big South,33,1033,201,374,201,369,0,5,131,200,132,237,369,37,26,50,72,78,533
2083,Isaiah Pineiro,JR,2017-18,F,San Diego,WCC,34,957,188,383,161,305,27,78,130,166,33,179,212,71,40,27,88,107,533
2084,LaQuinton Ross,JR,2013-14,F,Ohio State,Big Ten,35,1015,184,412,142,293,42,119,123,168,63,145,208,29,25,20,60,54,533
2085,JaJuan Smith,JR,2006-07,G,Tennessee,SEC,35,1012,183,402,94,160,89,242,78,107,60,99,159,46,73,8,63,90,533
2086,D'Vauntes Smith-Rivera,SR,2015-16,G,Georgetown,Big East,33,1168,172,416,99,195,73,221,116,143,22,98,120,150,48,10,69,78,533
2087,Ryan Taylor,JR,2017-18,G,Evansville,MVC,25,879,195,458,128,300,67,158,76,88,12,84,96,28,20,6,57,57,533
2088,Vedran Vukusic,SR,2005-06,F,Northwestern,Big Ten,28,1033,191,388,128,213,63,175,88,112,25,78,103,48,32,18,52,67,533
2089,Dean Wade,JR,2017-18,F,Kansas State,Big 12,33,1083,198,360,158,269,40,91,97,129,43,160,203,89,51,27,47,64,533
2090,Calvin Watson,SR,2006-07,G,North Texas,Sun Belt,34,1017,183,427,93,200,90,227,77,117,37,98,135,44,29,11,70,74,533
2091,Michael Weathers,FR,2016-17,G,Miami (OH),MAC,32,906,177,411,158,325,19,86,160,206,23,111,134,155,60,45,146,109,533
2092,Byron Wesley,JR,2013-14,G,Southern California,Pac-12,30,1038,191,409,167,338,24,71,127,178,46,147,193,69,27,10,61,51,533
2093,Jeremy Wise,JR,2008-09,G,Southern Mississippi,CUSA,32,1142,165,369,139,263,26,106,177,216,12,99,111,150,42,11,102,93,533
2096,J.J. Avila,JR,2013-14,F,Colorado State,MWC,32,1070,186,410,162,334,24,76,136,171,82,155,237,106,35,16,78,84,532
2097,Travis Betran,JR,2012-13,G,Austin Peay,OVC,31,1071,178,414,94,210,84,204,92,109,14,55,69,84,40,9,80,49,532
2098,Askia Booker,SR,2014-15,G,Colorado,Pac-12,31,936,173,447,118,280,55,167,131,157,15,88,103,99,44,2,70,56,532
2099,Keith Braxton,SO,2017-18,G,Saint Francis (PA),NEC,31,1091,180,379,140,270,40,109,132,166,50,245,295,102,54,18,81,56,532
2100,William Buford,SO,2009-10,G,Ohio State,Big Ten,37,1272,197,451,148,323,49,128,89,118,52,157,209,116,41,10,65,81,532
2101,Dominic Calegari,SR,2009-10,F,UC-Davis,Big West,32,979,187,369,127,225,60,144,98,137,41,128,169,65,35,30,76,90,532
2102,Drew Crawford,JR,2011-12,G,Northwestern,Big Ten,33,1143,195,403,134,255,61,148,81,115,40,115,155,68,40,19,54,67,532
2103,Brandon Davies,JR,2011-12,F,Brigham Young,WCC,35,1002,196,380,195,377,1,3,139,210,79,190,269,73,51,47,100,114,532
2104,Nana Foulland,SR,2017-18,C,Bucknell,Patriot,35,1001,210,358,210,356,0,2,112,201,76,169,245,46,18,61,63,92,532
2105,Christopher Galbreath Jr.,SR,2017-18,F,Sam Houston State,Southland,36,1004,219,464,202,413,17,51,77,115,94,193,287,45,23,21,79,101,532
2106,Matt Gatens,SR,2011-12,G,Iowa,Big Ten,35,1212,173,369,98,186,75,183,111,130,35,90,125,69,48,6,38,66,532
2107,Shai Gilgeous-Alexander,FR,2017-18,G,Kentucky,SEC,37,1248,183,377,160,320,23,57,143,175,33,120,153,189,61,18,100,62,532
2108,Malcolm Grant,JR,2010-11,G,Miami (FL),ACC,36,1165,158,378,64,156,94,222,122,143,12,53,65,115,31,1,92,49,532
2109,Jeremy Green,SO,2009-10,G,Stanford,Pac-10,32,1081,182,453,89,209,93,244,75,92,26,95,121,25,24,1,41,67,532
2110,Chris Hansen,SR,2014-15,G,Idaho State,Big Sky,30,998,157,389,77,180,80,209,138,165,11,90,101,70,39,0,59,45,532
2111,Adnan Hodzic,SR,2010-11,C,Lipscomb,A-Sun,30,949,206,366,205,358,1,8,119,164,68,156,224,30,8,2,66,73,532
2112,Kory Holden,SO,2015-16,G,Delaware,CAA,30,1088,181,459,112,281,69,178,101,127,16,75,91,126,12,2,88,62,532
2113,Chavis Holmes,JR,2007-08,G,Virginia Military Institute,Big South,29,897,186,419,104,191,82,228,78,110,43,81,124,73,70,11,62,74,532
2114,Jeremiah Jefferson,SR,2018-19,G,Nicholls State,Southland,31,1068,194,447,96,197,98,250,46,64,10,80,90,62,30,6,52,51,532
2115,Jarkell Joiner,SO,2018-19,G,Cal State Bakersfield,WAC,34,1096,208,461,158,326,50,135,66,93,40,81,121,49,37,3,43,71,532
2118,Johnathan Jordan,SR,2014-15,G,Texas A&M-Corpus Christi,Southland,34,1219,167,373,155,331,12,42,186,283,28,104,132,178,63,3,88,71,532
2119,Travis Munnings,SR,2018-19,F,Louisiana-Monroe,Sun Belt,35,1275,184,405,112,216,72,189,92,123,78,196,274,91,25,6,93,102,532
2120,Le'Bryan Nash,JR,2014-15,G,Oklahoma State,Big 12,31,982,178,385,176,365,2,20,174,220,37,139,176,62,24,29,100,92,532
2121,Shane Richards,SR,2015-16,F,Manhattan,MAAC,31,1125,154,398,76,183,78,215,146,170,19,99,118,52,29,3,63,77,532
2122,Shawn Roundtree,JR,2017-18,G,Central Michigan,MAC,36,1187,166,416,110,251,56,165,144,175,21,84,105,151,23,1,113,61,532
2123,Bryson Scott,JR,2016-17,G,Purdue-Fort Wayne,Summit,33,928,193,407,135,235,58,172,88,127,28,136,164,76,56,3,83,62,532
2124,Jordan Taylor,SR,2011-12,G,Wisconsin,Big Ten,36,1297,166,413,101,237,65,176,135,172,31,106,137,147,37,1,56,73,532
2125,Anthony Vereen,SR,2008-09,F,Texas-Arlington,Southland,30,889,176,303,166,275,10,28,170,217,59,136,195,67,23,4,49,90,532
2126,Tim Ambrose,SR,2010-11,G,Albany (NY),AEC,32,1086,192,422,130,277,62,145,85,122,40,126,166,116,43,5,96,89,531
2127,Anthony Beane,JR,2014-15,G,Southern Illinois,MVC,33,1148,187,442,139,298,48,144,109,134,18,69,87,36,41,10,59,72,531
2128,Marqus Blakely,JR,2008-09,F,Vermont,AEC,33,1080,199,326,198,323,1,3,132,235,94,203,297,84,67,88,108,102,531
2129,Jaylen Bland,SR,2015-16,G,UC-Riverside,Big West,33,1120,166,422,48,130,118,292,81,98,15,109,124,59,47,5,74,69,531
2130,Khadeen Carrington,SR,2017-18,G,Seton Hall,Big East,34,1120,170,407,117,263,53,144,138,167,20,86,106,150,36,10,79,73,531
2131,Jamelle Cornley,SR,2008-09,F,Penn State,Big Ten,37,1288,221,427,202,378,19,49,70,130,74,160,234,44,14,5,66,58,531
2132,Anthony Cowan,JR,2018-19,G,Maryland,Big Ten,34,1178,168,428,98,220,70,208,125,155,13,113,126,150,31,7,94,78,531
2133,Geno Crandall,JR,2017-18,G,North Dakota,Big Sky,32,1068,179,356,129,236,50,120,123,169,32,107,139,114,67,3,105,97,531
2134,Will Cummings,SR,2014-15,G,Temple,AAC,36,1224,159,396,135,291,24,105,189,234,33,114,147,151,67,7,71,86,531
2135,Taquan Dean,SR,2005-06,G,Louisville,Big East,31,1025,167,437,62,162,105,275,92,107,39,135,174,107,32,2,79,71,531
2136,Paul Delaney,SR,2008-09,G,Alabama-Birmingham,CUSA,33,1157,180,322,158,263,22,59,149,193,29,117,146,115,70,5,73,66,531
2137,James Florence,SO,2007-08,G,Mercer,A-Sun,28,896,179,507,112,265,67,242,106,160,14,102,116,84,49,6,106,94,531
2140,Shan Foster,JR,2006-07,G,Vanderbilt,SEC,34,1101,191,425,117,211,74,214,75,89,47,111,158,78,40,14,63,57,531
2141,Taurean Green,JR,2006-07,G,Florida,SEC,40,1328,154,347,72,145,82,202,141,166,9,87,96,147,42,1,107,60,531
2142,Ken Horton,SR,2011-12,F,Central Connecticut State,NEC,28,967,192,391,146,244,46,147,101,126,77,173,250,48,59,40,52,72,531
2143,Dominique Jones,FR,2007-08,G,South Florida,Big East,31,1085,177,385,123,232,54,153,123,162,44,99,143,86,47,8,70,73,531
2144,Marco Killingsworth,SR,2005-06,F,Indiana,Big Ten,31,882,211,389,207,368,4,21,105,173,76,166,242,59,22,21,122,106,531
2145,JeQuan Lewis,SR,2016-17,G,Virginia Commonwealth,A-10,35,1092,168,390,85,164,83,226,112,137,8,91,99,158,61,3,86,87,531
2146,Charles Matthews,JR,2017-18,G,Michigan,Big Ten,41,1234,205,414,171,307,34,107,87,156,53,174,227,98,30,26,84,88,531
2147,Cleveland Melvin,JR,2012-13,F,DePaul,Big East,32,994,216,451,201,400,15,51,84,124,81,136,217,25,39,26,72,58,531
2148,Ajdin Penava,JR,2017-18,F,Marshall,CUSA,34,1001,191,340,158,243,33,97,116,154,67,221,288,66,32,134,67,121,531
2149,Tim Pollitz,JR,2006-07,F,Miami (OH),MAC,33,1165,234,408,232,405,2,3,61,93,63,123,186,56,33,19,92,74,531
2150,Rome Sanders,SR,2006-07,C,Florida A&M,MEAC,35,,173,265,173,265,0,0,185,244,93,116,209,30,7,10,83,94,531
2151,John Shurna,JR,2010-11,F,Northwestern,Big Ten,32,1088,176,366,101,193,75,173,104,147,31,126,157,83,36,31,58,57,531
2152,Jamaal Tatum,SR,2006-07,G,Southern Illinois,MVC,35,1149,172,395,101,221,71,174,116,149,30,74,104,85,41,0,83,63,531
2153,PJ Washington,SO,2018-19,F,Kentucky,SEC,35,1024,190,364,157,286,33,78,118,178,81,183,264,63,29,43,69,86,531
2154,Charles Williams,FR,2016-17,G,Howard,MEAC,34,1019,179,452,113,259,66,193,107,141,34,54,88,20,19,12,57,73,531
2155,Grant Williams,SO,2017-18,F,Tennessee,SEC,35,1008,183,387,180,362,3,25,162,212,81,130,211,66,21,44,74,116,531
2156,Khalif Wyatt,JR,2011-12,G,Temple,A-10,31,1022,162,338,109,198,53,140,154,180,22,76,98,103,69,13,76,80,531
2157,Milik Yarbrough,JR,2017-18,F,Illinois State,MVC,32,895,172,380,141,273,31,107,156,194,46,164,210,152,30,21,126,85,531
2158,Jerrelle Benimon,SR,2012-13,F,Towson,CAA,31,1116,188,353,168,304,20,49,134,205,102,244,346,79,21,60,120,85,530
2159,Folarin Campbell,SR,2007-08,G,George Mason,CAA,34,1117,161,384,101,219,60,165,148,202,27,127,154,112,39,16,102,86,530
2160,Raasean Davis,JR,2017-18,C,North Carolina Central,MEAC,35,1015,233,347,233,346,0,1,64,109,102,180,282,15,20,35,70,82,530
2161,Seth Dugan,SR,2018-19,C,Western Michigan,MAC,32,1066,209,372,207,357,2,15,110,171,108,208,316,54,11,29,68,72,530
2162,Dorian Finney-Smith,SR,2015-16,F,Florida,SEC,36,1145,169,387,98,194,71,193,121,165,89,211,300,74,33,29,68,78,530
2163,Allerik Freeman,SR,2017-18,G,North Carolina State,ACC,33,1135,164,425,94,243,70,182,132,170,20,117,137,85,40,0,82,56,530
2164,Alex Hamilton,JR,2014-15,G,Louisiana Tech,CUSA,36,1099,170,395,136,276,34,119,156,209,28,91,119,94,62,9,76,63,530
2165,Darnell Harris,SR,2007-08,G,La Salle,A-10,32,1063,176,389,53,132,123,257,55,72,6,66,72,65,36,8,36,59,530
2166,Ryan Harrow,SR,2014-15,G,Georgia State,Sun Belt,29,923,208,413,165,304,43,109,71,99,11,49,60,104,42,3,55,43,530
2167,Frank Kaminsky,JR,2013-14,C,Wisconsin,Big Ten,38,1032,196,371,159,273,37,98,101,132,81,159,240,49,26,66,39,96,530
2168,Michael Lyons,SR,2012-13,G,Air Force,MWC,30,948,191,405,139,244,52,161,96,133,39,79,118,69,30,4,56,61,530
2169,Nazareth Mitrou-Long,SR,2016-17,G,Iowa State,Big 12,35,1164,185,391,87,136,98,255,62,78,24,136,160,93,43,1,59,75,530
2170,Kwame Morgan,JR,2010-11,G,Hampton,MEAC,33,1098,167,450,67,177,100,273,96,120,40,107,147,44,48,4,43,52,530
2171,Lamond Murray,JR,2015-16,G,Pepperdine,WCC,32,1009,207,442,176,363,31,79,85,112,49,124,173,28,30,17,40,69,530
2172,Ike Nwamu,JR,2014-15,G,Mercer,Southern,35,1163,171,400,91,185,80,215,108,142,24,91,115,56,26,14,75,62,530
2173,Jose Olivero,JR,2005-06,G,Lehigh,Patriot,31,1012,179,411,108,237,71,174,101,152,23,75,98,91,30,1,99,71,530
2174,Arizona Reid,SO,2005-06,F,High Point,Big South,29,980,218,449,201,413,17,36,77,110,81,178,259,49,42,9,89,57,530
2175,Terry Taylor,FR,2017-18,G,Austin Peay,OVC,34,1070,196,362,158,274,38,88,100,137,133,158,291,25,20,34,61,85,530
2176,Terrico White,SO,2009-10,G,Mississippi,SEC,35,1103,192,447,131,268,61,179,85,119,55,105,160,52,30,7,45,62,530
2177,Malik Beasley,FR,2015-16,G,Florida State,ACC,34,1014,185,393,130,251,55,142,104,128,44,136,180,51,32,6,59,75,529
2178,Derick Beltran,SR,2012-13,G,Southern,SWAC,33,1147,171,428,91,194,80,234,107,135,14,132,146,51,43,16,56,51,529
2179,Gary Blackston,SR,2018-19,G,Prairie View,SWAC,34,1062,176,410,127,267,49,143,128,195,59,178,237,63,57,6,68,91,529
2182,Shannon Evans,SR,2017-18,G,Arizona State,Pac-12,32,1117,156,412,61,156,95,256,122,143,11,93,104,112,44,9,53,60,529
2183,Gavin Grant,JR,2006-07,F,North Carolina State,ACC,36,1313,181,383,152,291,29,92,138,186,38,152,190,137,19,22,151,87,529
2184,Dusty Hannahs,JR,2015-16,G,Arkansas,SEC,32,866,174,380,93,193,81,187,100,115,19,58,77,29,20,0,41,68,529
2185,Justin Hawkins,JR,2006-07,G,New Mexico State,WAC,34,1110,195,372,186,345,9,27,130,185,76,149,225,79,44,12,91,104,529
2186,Twymond Howard,SR,2015-16,F,Tennessee-Martin,OVC,34,1129,187,414,165,353,22,61,133,180,41,196,237,83,24,13,78,80,529
2187,Ibrahim Jaaber,JR,2005-06,G,Pennsylvania,Ivy,29,1063,190,362,134,216,56,146,93,129,33,66,99,64,96,15,49,69,529
2188,Nick Lewis,SR,2005-06,F,San Diego,WCC,30,908,191,372,147,274,44,98,103,130,39,111,150,40,24,23,79,60,529
2189,Terrell Miller Jr.,JR,2016-17,F,Murray State,OVC,33,976,184,386,117,217,67,169,94,121,78,191,269,46,26,7,79,108,529
2190,Donovan Mitchell,SO,2016-17,G,Louisville,ACC,34,1098,181,444,101,218,80,226,87,108,37,128,165,93,70,17,56,88,529
2191,Tyler Nelson,SO,2015-16,G,Fairfield,MAAC,33,1169,158,368,92,177,66,191,147,167,16,87,103,95,44,0,53,43,529
2192,Nick Perkins,SR,2018-19,F,Buffalo,MAC,36,943,184,393,137,268,47,125,114,170,72,195,267,24,17,30,64,83,529
2193,Marcquise Reed,FR,2014-15,G,Robert Morris,NEC,35,973,197,402,164,322,33,80,102,131,20,68,88,73,67,1,90,72,529
2194,Jontae Sherrod,SR,2010-11,G,East Carolina,CUSA,34,1016,153,360,80,173,73,187,150,189,26,96,122,64,37,3,81,94,529
2195,Bernard Thompson,SO,2012-13,G,Florida Gulf Coast,A-Sun,37,1107,190,406,136,264,54,142,95,144,49,114,163,64,102,4,80,93,529
2196,Savalance Townsend,SR,2011-12,G,Arkansas-Pine Bluff,SWAC,33,1233,170,414,135,311,35,103,154,210,38,117,155,103,73,22,98,71,529
2197,Brad Waldow,JR,2013-14,F,Saint Mary's (CA),WCC,35,1013,191,338,191,337,0,1,147,239,111,150,261,50,21,46,59,80,529
2198,Thomas Walkup,JR,2014-15,G,Stephen F. Austin,Southland,34,943,185,326,174,284,11,42,148,199,84,136,220,126,40,6,73,100,529
2199,Pendarvis Williams,SR,2013-14,G,Norfolk State,MEAC,34,1172,184,375,123,203,61,172,100,120,39,129,168,89,51,10,55,84,529
2200,Muhammad-Ali Abdur-Rahkman,SR,2017-18,G,Michigan,Big Ten,41,1432,179,415,106,220,73,195,97,129,27,131,158,132,35,7,30,64,528
2201,De'Angelo Alexander,SR,2006-07,G,Charlotte,A-10,30,1049,177,443,99,210,78,233,96,122,90,125,215,55,38,6,60,67,528
2204,Craig Brackins,JR,2009-10,F,Iowa State,Big 12,32,1124,192,457,165,370,27,87,117,154,67,206,273,69,25,38,68,64,528
2205,Keith Braxton,JR,2018-19,G,Saint Francis (PA),NEC,33,1129,182,398,141,277,41,121,123,160,56,266,322,124,49,11,82,56,528
2206,Jalen Brunson,SO,2016-17,G,Villanova,Big East,36,1118,183,338,141,227,42,111,120,137,17,76,93,148,32,0,74,59,528
2207,Draelon Burns,SR,2007-08,G,DePaul,Big East,30,962,173,430,110,248,63,182,119,147,27,74,101,74,51,3,54,54,528
2208,Marcus Graves,SR,2018-19,G,Sacramento State,Big Sky,31,1077,182,431,132,302,50,129,114,144,28,119,147,167,61,2,96,81,528
2209,Jeff Green,JR,2006-07,F,Georgetown,Big East,37,1232,196,382,160,286,36,96,100,129,62,174,236,117,30,43,96,92,528
2210,Jalen Hudson,JR,2017-18,G,Florida,SEC,34,904,179,393,101,200,78,193,92,139,13,119,132,36,26,20,40,72,528
2211,Sean Kilpatrick,SO,2011-12,G,Cincinnati,Big East,37,1277,185,432,93,187,92,245,66,88,52,117,169,78,49,12,56,49,528
2212,Romeo Langford,FR,2018-19,G,Indiana,Big Ten,32,1090,177,395,143,270,34,125,140,194,45,127,172,75,25,26,68,60,528
2213,C.J. Leslie,JR,2012-13,F,North Carolina State,ACC,35,1135,192,370,190,364,2,6,142,232,65,193,258,51,34,43,105,86,528
2214,Max Mahoney,JR,2018-19,F,Boston University,Patriot,32,865,222,353,222,353,0,0,84,132,81,129,210,53,25,21,61,102,528
2215,Yante Maten,JR,2016-17,F,Georgia,SEC,29,842,179,345,158,302,21,43,149,208,72,125,197,43,21,43,72,79,528
2216,Travis Niesen,SR,2005-06,F,Santa Clara,WCC,28,947,190,422,175,371,15,51,133,195,48,137,185,44,20,5,86,69,528
2217,Jose Perez,FR,2018-19,G,Gardner-Webb,Big South,35,1101,175,391,122,252,53,139,125,178,35,164,199,105,27,8,69,62,528
2218,Sayeed Pridgett,JR,2018-19,G,Montana,Big Sky,35,1045,230,380,211,339,19,41,49,86,46,126,172,78,44,17,85,98,528
2219,Cameron Reynolds,JR,2016-17,G,Tulane,AAC,31,1090,184,434,106,233,78,201,82,103,43,167,210,45,26,14,47,84,528
2220,Blake Schilb,SR,2006-07,G,Loyola (IL),Horizon,31,1034,179,396,126,247,53,149,117,137,36,125,161,124,41,19,103,54,528
2221,Jackson Stevenett,SR,2012-13,F,Southern Utah,Big Sky,30,1014,184,410,161,333,23,77,137,158,62,122,184,53,23,21,62,83,528
2222,Ahmad Thomas,SR,2017-18,G,North Carolina-Asheville,Big South,32,1028,220,438,203,376,17,62,71,107,50,136,186,91,62,11,77,88,528
2223,Tai Webster,SR,2016-17,G,Nebraska,Big Ten,31,1075,183,435,143,299,40,136,122,164,33,125,158,124,42,4,100,74,528
2226,James Woodard,SO,2013-14,G,Tulsa,CUSA,34,1101,162,370,97,202,65,168,139,178,53,148,201,60,32,6,46,76,528
2227,Kyan Anderson,JR,2013-14,G,Texas Christian,Big 12,31,1072,161,342,115,229,46,113,159,187,9,66,75,139,43,1,90,54,527
2228,Kyle Anderson,SO,2013-14,G,UCLA,Pac-12,36,1196,181,377,153,319,28,58,137,186,45,270,315,233,64,27,110,60,527
2229,La'Shard Anderson,SR,2010-11,G,Boise State,WAC,35,1128,176,404,143,296,33,108,142,181,29,84,113,165,77,13,109,111,527
2230,Jahsha Bluntt,SR,2006-07,G,Delaware State,MEAC,34,1228,169,400,90,174,79,226,110,134,57,109,166,53,40,6,67,79,527
2231,Stephen Brown,SR,2017-18,G,Bucknell,Patriot,35,1059,186,386,122,215,64,171,91,109,17,98,115,150,41,9,61,82,527
2232,Deonte Burton,SR,2016-17,G,Iowa State,Big 12,35,1034,203,445,161,333,42,112,79,117,40,178,218,62,60,49,80,105,527
2233,Thomas Coleman,SR,2010-11,F,North Carolina A&T,MEAC,31,989,200,323,200,322,0,1,127,199,116,209,325,44,36,83,79,76,527
2234,Cliff Colimon,SR,2011-12,G,Eastern Washington,Big Sky,32,1123,173,430,107,247,66,183,115,142,19,101,120,160,52,4,105,87,527
2235,Johnny Dee,SR,2014-15,G,San Diego,WCC,31,965,167,390,87,179,80,211,113,123,11,96,107,40,36,2,32,45,527
2236,Noah Dickerson,JR,2017-18,F,Washington,Pac-12,34,915,178,313,176,308,2,5,169,215,93,191,284,30,23,19,77,114,527
2237,Langston Galloway,SO,2011-12,G,Saint Joseph's,A-10,34,1215,182,373,92,180,90,193,73,93,34,119,153,76,35,20,41,91,527
2238,JaMychal Green,JR,2010-11,F,Alabama,SEC,34,948,190,374,189,373,1,1,146,198,106,150,256,49,49,70,95,111,527
2239,R.J. Hunter,FR,2012-13,G,Georgia State,CAA,31,1038,175,399,102,199,73,200,104,134,30,128,158,57,53,26,52,52,527
2240,Armon Johnson,SO,2008-09,G,Nevada,WAC,34,1097,193,448,168,358,25,90,116,147,27,95,122,145,30,6,84,42,527
2241,Ben Lammers,JR,2016-17,C,Georgia Tech,ACC,37,1309,214,415,213,413,1,2,98,133,111,231,342,78,43,125,64,85,527
2242,Jaron Lane,SR,2013-14,F,North Carolina-Asheville,Big South,32,1070,168,335,132,246,36,89,155,201,49,128,177,48,30,14,53,68,527
2243,Greg Mangano,SR,2011-12,F,Yale,Ivy,29,931,197,416,159,302,38,114,95,145,91,188,279,14,12,65,57,78,527
2244,Jared Newson,SR,2005-06,F,Tennessee-Martin,OVC,28,980,181,400,145,311,36,89,129,182,53,132,185,39,48,16,75,52,527
2245,Juvonte Reddic,JR,2012-13,F,Virginia Commonwealth,A-10,36,1004,210,369,209,363,1,6,106,150,122,169,291,23,50,31,59,83,527
2248,Austin Rivers,FR,2011-12,G,Duke,ACC,34,1129,174,402,116,243,58,159,121,184,21,94,115,71,33,1,79,76,527
2249,Augustine Rubit,SR,2013-14,F,South Alabama,Sun Belt,31,973,185,400,164,336,21,64,136,204,129,163,292,42,23,46,61,79,527
2250,Tyler Seibring,SR,2018-19,F,Elon,CAA,32,1044,191,396,114,209,77,187,68,85,44,145,189,49,14,16,28,52,527
2251,Kendall Anthony,JR,2013-14,G,Richmond,A-10,33,1028,166,429,84,197,82,232,112,136,14,36,50,54,21,1,46,75,526
2252,Marcus Barham,SR,2017-18,G,Florida A&M,MEAC,31,1115,169,431,84,197,85,234,103,123,32,101,133,59,25,6,92,60,526
2253,Brayon Blake,SR,2017-18,F,Idaho,Big Sky,31,898,202,404,150,288,52,116,70,106,65,233,298,38,22,15,60,93,526
2254,Craig Bradshaw,SR,2015-16,G,Belmont,OVC,32,1034,176,399,89,164,87,235,87,118,25,101,126,103,40,12,77,80,526
2255,Devin Carter,SR,2016-17,G,Arkansas State,Sun Belt,32,1055,177,410,75,156,102,254,70,98,23,91,114,25,29,5,39,76,526
2256,Quenton DeCosey,SR,2015-16,G,Temple,AAC,33,1142,164,407,115,270,49,137,149,191,42,157,199,85,41,13,73,65,526
2257,James Feldeine,JR,2008-09,G,Quinnipiac,NEC,31,1057,189,454,143,318,46,136,102,137,50,135,185,73,52,11,98,66,526
2258,Langston Hall,SR,2013-14,G,Mercer,A-Sun,36,1157,152,380,66,160,86,220,136,160,14,97,111,201,52,5,85,51,526
2259,Marvelle Harris,JR,2014-15,G,Fresno State,MWC,32,1168,174,402,121,237,53,165,125,169,23,138,161,120,65,8,85,96,526
2260,Omega Harris,JR,2016-17,G,Texas-El Paso,CUSA,31,1127,183,403,134,273,49,130,111,141,11,100,111,66,40,5,86,67,526
2261,Mustapha Heron,SO,2017-18,G,Auburn,SEC,32,916,172,392,129,262,43,130,139,173,41,129,170,30,38,2,66,82,526
2262,Gerald Lee,JR,2008-09,C,Old Dominion,CAA,34,1046,202,373,200,366,2,7,120,159,78,115,193,49,23,28,68,75,526
2263,Rob Marberry,JR,2017-18,F,Lipscomb,A-Sun,33,940,218,356,218,354,0,2,90,122,67,125,192,62,23,23,50,76,526
2264,Chima Moneke,JR,2016-17,F,UC-Davis,Big West,36,981,192,364,192,364,0,0,142,220,92,249,341,29,32,51,94,95,526
2265,Jalen Moore,SR,2016-17,F,Utah State,MWC,32,1117,181,379,118,231,63,148,101,128,29,143,172,82,16,15,65,46,526
2266,Darius Morris,SO,2010-11,G,Michigan,Big Ten,35,1219,201,411,185,347,16,64,108,151,31,108,139,235,36,1,103,74,526
2267,Kyle O'Quinn,JR,2010-11,C,Norfolk State,MEAC,32,1050,198,356,183,293,15,63,115,151,107,248,355,32,18,110,68,114,526
2268,Tayler Persons,SO,2016-17,G,Ball State,MAC,34,986,183,382,139,277,44,105,116,152,13,118,131,167,44,2,105,88,526
2269,Myles Powell,SO,2017-18,G,Seton Hall,Big East,34,1078,171,395,77,147,94,248,90,114,17,73,90,94,34,8,68,82,526
2270,Brandon Rush,SO,2006-07,G,Kansas,Big 12,38,1234,186,420,111,246,75,174,79,116,58,154,212,76,15,34,78,60,526
2271,Omar Strong,SR,2012-13,G,Texas Southern,SWAC,31,1102,164,427,44,98,120,329,78,92,19,86,105,65,27,0,67,65,526
2272,Dominique Sutton,SR,2011-12,F,North Carolina Central,MEAC,32,1086,183,316,183,314,0,2,160,241,63,175,238,54,71,17,84,100,526
2273,B.J. Taylor,SR,2018-19,G,Central Florida,AAC,33,1135,139,362,78,198,61,164,187,240,11,66,77,107,29,0,54,46,526
2274,Terrence Todd,SR,2005-06,G,Fairfield,MAAC,28,898,201,442,174,359,27,83,97,120,29,85,114,73,29,1,58,62,526
2275,Edwin Ubiles,JR,2008-09,F,Siena,MAAC,35,1174,208,422,187,354,21,68,89,140,55,117,172,75,52,34,91,46,526
2276,Davon Usher,JR,2012-13,G,Mississippi Valley State,SWAC,28,915,158,379,97,225,61,154,149,191,48,122,170,40,45,10,63,65,526
2277,Marlain Veal,SR,2018-19,G,Southeastern Louisiana,Southland,33,1032,148,391,78,192,70,199,160,194,25,88,113,147,58,3,147,84,526
2278,Kyle Visser,SR,2006-07,C,Wake Forest,ACC,31,899,188,322,188,320,0,2,150,233,89,140,229,19,23,42,61,79,526
2279,Kobe Webster,SO,2018-19,G,Western Illinois,Summit,31,1054,195,455,119,271,76,184,60,85,14,123,137,97,34,1,50,60,526
2280,Tim Abromaitis,SR,2010-11,F,Notre Dame,Big East,34,1162,169,371,91,189,78,182,109,139,45,161,206,61,26,15,52,66,525
2281,Kenny Boynton,SO,2010-11,G,Florida,SEC,37,1218,169,439,89,197,80,242,107,130,15,39,54,98,32,9,53,49,525
2282,Earl Clark,JR,2008-09,F,Louisville,Big East,37,1269,202,442,171,347,31,95,90,139,102,220,322,119,38,51,119,71,525
2283,Tre' Coggins,SR,2016-17,G,Cal State Fullerton,Big West,30,966,177,429,88,179,89,250,82,98,10,96,106,37,28,4,61,55,525
2284,Ella Ellis,JR,2011-12,F,Army,Patriot,30,915,161,391,98,215,63,176,140,169,43,104,147,63,25,12,71,58,525
2285,James Gist,SR,2007-08,F,Maryland,ACC,33,1056,194,391,172,320,22,71,115,156,60,200,260,45,42,77,90,101,525
2286,Javonte Green,SR,2014-15,F,Radford,Big South,34,891,185,340,184,331,1,9,154,221,97,210,307,43,65,29,69,85,525
2287,Venky Jois,SR,2015-16,F,Eastern Washington,Big Sky,32,1060,220,324,220,324,0,0,85,181,59,219,278,79,32,56,82,78,525
2290,DaVonte Lacy,SR,2014-15,G,Washington State,Pac-12,31,1005,158,389,90,183,68,206,141,183,22,59,81,66,20,4,56,68,525
2291,Michael Lee,SR,2007-08,F,St. Bonaventure,A-10,30,1088,193,397,161,313,32,84,107,152,68,172,240,43,44,16,86,64,525
2292,Elfrid Payton,SO,2012-13,G,Louisiana,Sun Belt,33,1171,187,394,171,344,16,50,135,210,46,138,184,181,80,21,113,76,525
2293,Ryan Schneider,SR,2008-09,F,Marist,MAAC,33,1239,161,425,73,184,88,241,115,137,41,230,271,45,47,23,81,59,525
2294,Mike Singletary,JR,2009-10,F,Texas Tech,Big 12,35,1209,167,372,145,298,22,74,169,238,51,188,239,80,43,26,97,95,525
2295,Willie Warren,FR,2008-09,G,Oklahoma,Big 12,36,1128,172,364,105,184,67,180,114,146,18,62,80,113,41,2,80,81,525
2296,Tremont Waters,FR,2017-18,G,Louisiana State,SEC,33,1089,168,403,96,198,72,205,117,146,10,101,111,198,67,3,96,74,525
2297,Matt Webster,SR,2006-07,F,Evansville,MVC,31,864,150,299,132,262,18,37,207,282,50,116,166,63,23,6,95,99,525
2298,Lonzo Ball,FR,2016-17,G,UCLA,Pac-12,36,1263,189,343,109,149,80,194,66,98,33,183,216,274,66,28,89,65,524
2299,Bryce Brown,JR,2017-18,G,Auburn,SEC,33,1031,169,421,62,141,107,280,79,102,19,46,65,55,32,7,43,55,524
2300,Jordan Caroline,SO,2016-17,G,Nevada,MWC,35,1230,174,376,146,293,28,83,148,251,122,199,321,68,39,11,62,83,524
2301,Marcus Colbert,SR,2015-16,G,Montana State,Big Sky,31,1040,188,445,135,294,53,151,95,130,26,69,95,158,34,3,83,96,524
2302,Toney Douglas,JR,2007-08,G,Florida State,ACC,34,1205,178,414,116,240,62,174,106,131,25,83,108,98,90,11,95,90,524
2303,Phil Fayne,SR,2018-19,F,Illinois State,MVC,33,954,199,367,199,366,0,1,126,193,98,110,208,26,36,40,57,108,524
2304,Jimmy Hall,JR,2015-16,F,Kent State,MAC,32,960,212,434,206,414,6,20,94,134,93,161,254,72,20,18,97,87,524
2305,J.C. Hampton,JR,2015-16,G,Lipscomb,A-Sun,33,1087,170,424,99,223,71,201,113,136,29,91,120,90,38,4,64,62,524
2306,Ricky Hickman,JR,2005-06,G,North Carolina-Greensboro,Southern,28,985,170,404,108,221,62,183,122,179,46,73,119,68,77,7,91,78,524
2307,Matt Lojeski,SR,2006-07,G,Hawaii,WAC,31,1122,193,357,149,241,44,116,94,116,48,129,177,139,52,22,92,61,524
2308,Phil Martin,SR,2011-12,G,UC-Riverside,Big West,30,1056,191,449,152,338,39,111,103,128,36,131,167,31,15,13,73,53,524
2309,Frantz Massenat,SR,2013-14,G,Drexel,CAA,30,1105,161,398,119,279,42,119,160,222,17,96,113,142,23,12,57,83,524
2312,Lotanna Nwogbo,SR,2015-16,F,Longwood,Big South,33,987,194,328,193,326,1,2,135,206,104,168,272,19,16,43,84,102,524
2313,J.P. Primm,SR,2011-12,G,North Carolina-Asheville,Big South,34,1088,158,367,83,162,75,205,133,158,18,94,112,142,64,2,81,84,524
2314,Jordon Talley,SR,2017-18,G,North Carolina-Wilmington,CAA,31,939,179,423,104,236,75,187,91,113,16,71,87,176,30,2,78,94,524
2315,Charlie Westbrook,SR,2011-12,G,South Dakota,Summit,28,907,183,394,146,299,37,95,121,158,23,89,112,62,48,24,71,62,524
2316,Josh Williams,SO,2014-15,G,Lipscomb,A-Sun,31,978,177,369,108,193,69,176,101,138,50,102,152,61,42,5,72,87,524
2317,Emmy Andujar,SR,2014-15,F,Manhattan,MAAC,32,1019,192,375,188,359,4,16,135,192,86,157,243,111,65,7,131,93,523
2318,Daniel Bejarano,JR,2013-14,G,Colorado State,MWC,32,1084,164,450,103,260,61,190,134,169,73,194,267,105,35,18,58,59,523
2319,Kerry Blackshear Jr.,JR,2018-19,F,Virginia Tech,ACC,35,1050,184,362,163,299,21,63,134,182,108,156,264,83,23,28,63,114,523
2320,Jarrell Brown,JR,2006-07,G,Army,Patriot,31,868,179,429,92,215,87,214,78,91,16,58,74,46,25,1,42,38,523
2321,Bryant Crawford,JR,2017-18,G,Wake Forest,ACC,31,987,164,397,107,238,57,159,138,159,12,79,91,152,48,5,101,74,523
2322,Dwayne Curtis,SR,2007-08,C,Mississippi,SEC,35,1089,212,335,212,335,0,0,99,147,154,183,337,35,28,10,58,82,523
2323,Lenny Daniel,SR,2010-11,F,Cal State Northridge,Big West,32,911,185,328,185,328,0,0,153,265,114,187,301,22,13,38,85,93,523
2324,Michael Haddix,SR,2006-07,C,Siena,MAAC,32,952,205,365,205,365,0,0,113,168,94,146,240,27,21,22,51,87,523
2325,Pierre Jackson,JR,2011-12,G,Baylor,Big 12,38,1172,174,378,105,209,69,169,106,129,33,77,110,223,68,3,134,88,523
2326,Janari Joesaar,SO,2014-15,F,Texas-Rio Grande Valley,WAC,31,1053,157,341,95,177,62,164,147,180,67,139,206,75,39,18,86,80,523
2327,Stanley Johnson,FR,2014-15,F,Arizona,Pac-12,38,1081,174,390,131,274,43,116,132,178,75,172,247,63,57,15,82,100,523
2328,David Kool,SO,2007-08,G,Western Michigan,MAC,32,1032,158,378,87,189,71,189,136,159,12,91,103,75,27,2,78,68,523
2329,Rickey McGill,SR,2018-19,G,Iona,MAAC,33,1228,173,366,126,232,47,134,130,171,31,117,148,160,78,9,92,84,523
2330,Rodney McGruder,JR,2011-12,G,Kansas State,Big 12,33,1085,188,406,138,276,50,130,97,121,75,98,173,46,38,9,50,63,523
2331,Jerel McNeal,JR,2007-08,G,Marquette,Big East,35,1056,198,434,163,319,35,115,92,131,56,115,171,124,76,15,98,109,523
2334,Johnny O'Bryant,JR,2013-14,F,Louisiana State,SEC,34,1020,202,409,201,406,1,3,118,186,102,160,262,55,17,31,108,108,523
2335,Femi Olujobi,JR,2017-18,F,North Carolina A&T,MEAC,32,1022,185,345,167,283,18,62,135,174,54,191,245,37,14,22,80,85,523
2336,Earl Pettis,SR,2011-12,G,La Salle,A-10,34,1064,199,429,141,267,58,162,67,84,14,122,136,75,64,12,53,83,523
2337,Payton Pritchard,SO,2017-18,G,Oregon,Pac-12,36,1265,178,398,93,192,85,206,82,106,18,120,138,171,51,0,76,88,523
2338,Levi Randolph,SR,2014-15,G,Alabama,SEC,34,1200,169,351,130,239,39,112,146,174,32,142,174,84,50,6,48,72,523
2339,Ahmaad Rorie,SR,2018-19,G,Montana,Big Sky,35,1215,194,416,131,239,63,177,72,89,18,125,143,142,32,2,54,63,523
2340,Josh Scott,SR,2015-16,F,Colorado,Pac-12,32,979,187,352,184,343,3,9,146,195,87,195,282,58,20,51,40,56,523
2341,Wayne Selden,JR,2015-16,G,Kansas,Big 12,38,1134,189,399,115,210,74,189,71,116,30,101,131,100,28,11,71,77,523
2342,Bryce Taylor,JR,2006-07,G,Oregon,Pac-10,37,1211,180,348,126,220,54,128,109,132,61,109,170,64,37,7,55,78,523
2343,Kellen Thornton,SR,2012-13,F,Tennessee State,OVC,33,1025,211,393,190,329,21,64,80,113,96,169,265,35,31,22,75,106,523
2344,Reggie Upshaw,SR,2016-17,F,Middle Tennessee,CUSA,36,1152,199,379,166,275,33,104,92,127,79,166,245,85,40,31,55,81,523
2345,Billy Wampler,JR,2018-19,F,Wright State,Horizon,35,970,169,397,91,183,78,214,107,132,24,95,119,41,19,5,38,72,523
2346,Kirk Williams,JR,2007-08,F,Longwood,Ind,31,1017,195,438,159,321,36,117,97,152,69,131,200,72,53,12,109,101,523
2347,V.J. Beachem,SR,2016-17,F,Notre Dame,ACC,36,1230,187,443,100,202,87,241,61,73,23,123,146,31,33,38,40,46,522
2348,Beau Beech,SR,2015-16,G,North Florida,A-Sun,34,1082,168,369,71,140,97,229,89,113,40,177,217,67,42,17,55,100,522
2349,Jeff Beverly,JR,2016-17,F,Texas-San Antonio,CUSA,33,889,183,461,161,366,22,95,134,178,76,118,194,33,13,6,77,96,522
2350,T.J. Carter,SR,2007-08,G,North Carolina-Wilmington,CAA,33,1061,173,403,140,278,33,125,143,167,55,126,181,135,44,14,93,91,522
2351,Will Clyburn,SR,2012-13,G,Iowa State,Big 12,35,1104,166,375,125,242,41,133,149,194,71,168,239,73,32,13,92,53,522
2352,Jerome Frink,SR,2016-17,F,Long Island University,NEC,31,1012,200,423,171,337,29,86,93,146,69,206,275,72,30,31,91,84,522
2353,Ashton Gibbs,JR,2010-11,G,Pittsburgh,Big East,31,1016,170,363,68,155,102,208,80,90,11,62,73,86,13,0,51,41,522
2356,Hillary Haley,JR,2010-11,G,Maryland-Eastern Shore,MEAC,31,924,171,415,121,255,50,160,130,179,58,122,180,22,22,6,51,67,522
2357,Murphy Holloway,SR,2012-13,F,Mississippi,SEC,36,1131,214,385,213,377,1,8,93,171,126,224,350,45,58,25,75,86,522
2358,Quinton Hosley,JR,2005-06,G,Fresno State,WAC,28,982,169,414,122,277,47,137,137,183,92,165,257,38,58,31,69,74,522
2359,Paul Jackson,JR,2017-18,G,Eastern Michigan,MAC,35,1225,193,469,161,361,32,108,104,143,12,62,74,162,48,2,99,83,522
2360,Jazz Johnson,SO,2016-17,G,Portland,WCC,33,1158,177,399,116,252,61,147,107,130,11,83,94,75,27,2,78,76,522
2361,Bronson Koenig,SR,2016-17,G,Wisconsin,Big Ten,36,1129,181,432,78,170,103,262,57,63,6,71,77,73,23,12,51,61,522
2362,Shane Larkin,SO,2012-13,G,Miami (FL),ACC,36,1311,183,382,114,212,69,170,87,112,17,121,138,164,71,4,82,59,522
2363,Courtney Lee,SO,2005-06,G,Western Kentucky,Sun Belt,30,932,180,399,118,247,62,152,100,118,64,125,189,86,77,10,82,71,522
2364,Stan Okoye,SO,2010-11,F,Virginia Military Institute,Big South,31,901,193,376,159,280,34,96,102,143,85,164,249,52,35,24,70,78,522
2365,Albert Owens,JR,2016-17,C,Oral Roberts,Summit,30,934,206,419,203,407,3,12,107,147,68,99,167,29,14,37,61,67,522
2366,Rodney Pryor,JR,2015-16,G,Robert Morris,NEC,29,931,178,410,129,241,49,169,117,136,52,179,231,48,42,25,83,73,522
2367,Braylon Rayson,JR,2015-16,G,Central Michigan,MAC,32,1024,181,433,100,222,81,211,79,96,21,96,117,55,29,0,60,57,522
2368,Drake Reed,SO,2006-07,F,Austin Peay,OVC,33,1102,207,399,205,388,2,11,106,169,79,120,199,56,32,13,86,84,522
2369,Jonathan Rodriguez,SR,2009-10,F,Campbell,A-Sun,30,978,163,339,140,267,23,72,173,222,72,170,242,60,45,15,75,70,522
2370,D'Vauntes Smith-Rivera,JR,2014-15,G,Georgetown,Big East,32,1102,157,373,85,187,72,186,136,158,26,108,134,101,51,6,52,67,522
2371,Marreese Speights,SO,2007-08,C,Florida,SEC,36,874,216,346,216,346,0,0,90,130,93,197,290,34,15,49,62,82,522
2372,Vernon Teel,JR,2009-10,G,Loyola Marymount,WCC,34,1195,171,350,153,305,18,45,162,239,62,117,179,190,61,21,118,90,522
2373,Aaron Thomas,SO,2013-14,G,Florida State,ACC,36,1135,172,379,133,274,39,105,139,172,36,116,152,65,57,11,88,88,522
2374,Sedrick Barefield,SR,2018-19,G,Utah,Pac-12,31,999,167,409,74,169,93,240,94,114,10,55,65,118,29,0,81,65,521
2375,Jaycee Carroll,SO,2005-06,G,Utah State,WAC,32,1065,184,396,91,190,93,206,60,76,17,96,113,83,31,4,55,59,521
2376,Tim Clifford,SR,2007-08,C,Holy Cross,Patriot,29,928,205,359,191,317,14,42,97,124,85,73,158,35,21,67,73,100,521
2377,Brandon Edwards,SR,2013-14,F,Texas-Arlington,Sun Belt,32,1104,173,335,132,221,41,114,134,171,114,200,314,26,24,55,43,84,521
2378,Robert Franks,JR,2017-18,F,Washington State,Pac-12,30,989,175,368,109,205,66,163,105,123,49,148,197,58,15,29,70,85,521
2379,Tobias Harris,FR,2010-11,F,Tennessee,SEC,34,993,185,402,162,326,23,76,128,170,67,180,247,44,24,29,62,70,521
2380,Austin Kenon,SO,2008-09,G,Virginia Military Institute,Big South,32,1017,171,398,52,93,119,305,60,84,29,77,106,78,45,0,54,74,521
2381,Dedric Lawson,FR,2015-16,F,Memphis,AAC,33,1062,182,445,154,365,28,80,129,182,104,203,307,84,39,55,104,86,521
2382,Brook Lopez,SO,2007-08,F,Stanford,Pac-10,27,831,184,393,184,387,0,6,153,194,77,144,221,37,16,56,58,66,521
2383,Skip Mills,JR,2005-06,F,Ball State,MAC,28,987,178,394,118,227,60,167,105,142,56,94,150,69,41,4,71,60,521
2384,Tasmin Mitchell,SR,2009-10,F,Louisiana State,SEC,31,1157,196,453,164,359,32,94,97,133,94,198,292,59,41,16,69,70,521
2385,Luke Nelson,JR,2015-16,G,UC-Irvine,Big West,38,1178,177,412,94,180,83,232,84,97,12,98,110,149,48,4,67,66,521
2386,Georges Niang,JR,2014-15,F,Iowa State,Big 12,34,1045,187,406,141,291,46,115,101,125,35,149,184,117,17,16,91,96,521
2387,L.J. Peak,JR,2016-17,G,Georgetown,Big East,32,1051,168,349,135,248,33,101,152,191,33,89,122,111,34,12,86,88,521
2388,Kendrick Perry,SO,2011-12,G,Youngstown State,Horizon,31,1078,177,367,123,215,54,152,113,160,17,85,102,121,74,8,64,58,521
2389,Wesley Person,SO,2015-16,G,Troy,Sun Belt,31,1089,171,403,75,146,96,257,83,109,17,92,109,46,7,5,38,42,521
2390,Jalen Pickett,FR,2018-19,G,Siena,MAAC,33,1225,184,422,119,235,65,187,88,118,43,109,152,221,66,29,80,77,521
2391,Sylvester Seay,JR,2008-09,F,Fresno State,WAC,34,1018,177,396,127,261,50,135,117,169,60,136,196,39,35,58,82,95,521
2392,Mike Smith,JR,2008-09,F,East Tennessee State,A-Sun,34,1188,175,387,131,265,44,122,127,164,50,213,263,72,46,17,63,104,521
2393,Max Strus,JR,2017-18,G,DePaul,Big East,31,1104,171,419,90,176,81,243,98,122,48,127,175,85,40,16,82,90,521
2394,Isiah Williams,JR,2010-11,G,Utah Valley,GWC,30,921,169,425,87,207,82,218,101,119,11,70,81,56,13,3,56,69,521
2395,Eric Wise,SO,2009-10,F,UC-Irvine,Big West,32,1044,190,420,184,393,6,27,135,193,73,134,207,97,30,15,67,80,521
2398,Brandon Young,SR,2013-14,G,DePaul,Big East,32,1114,178,411,149,297,29,114,136,201,20,115,135,113,57,9,99,61,521
2399,Cole Aldrich,SO,2008-09,C,Kansas,Big 12,35,1037,199,333,199,333,0,0,122,154,106,281,387,36,21,94,56,90,520
2400,Corey Allmond,SR,2009-10,G,Sam Houston State,Southland,33,1022,183,419,87,162,96,257,58,79,13,65,78,77,32,0,45,36,520
2401,Francis Alonso,SO,2016-17,G,North Carolina-Greensboro,Southern,35,1007,152,338,50,117,102,221,114,130,11,55,66,71,29,2,64,83,520
2402,Dee Bost,SR,2011-12,G,Mississippi State,SEC,33,1197,159,406,84,189,75,217,127,166,18,92,110,183,66,7,100,73,520
2403,Brandon Bowdry,JR,2009-10,F,Eastern Michigan,MAC,32,1024,196,402,185,361,11,41,117,184,89,230,319,36,35,14,74,95,520
2404,Denzel Bowles,JR,2009-10,F,James Madison,CAA,25,819,203,342,203,342,0,0,114,172,80,150,230,62,13,36,86,72,520
2405,David Brown,SR,2014-15,G,Western Michigan,MAC,34,1119,165,389,80,152,85,237,105,143,13,103,116,73,45,4,63,94,520
2406,William Buford,JR,2010-11,G,Ohio State,Big Ten,36,1167,200,433,139,295,61,138,59,70,35,106,141,106,29,11,66,78,520
2407,Garrett Callahan,JR,2008-09,G,South Dakota State,Summit,33,1125,163,369,84,184,79,185,115,137,21,80,101,63,26,2,82,69,520
2408,Bill Clark,SR,2010-11,G,Duquesne,A-10,32,993,162,350,87,152,75,198,121,162,67,132,199,80,47,16,63,100,520
2409,Tyler Davis,JR,2017-18,C,Texas A&M,SEC,35,1018,206,352,199,327,7,25,101,162,123,190,313,44,12,47,70,90,520
2410,Bobby Dixon,SR,2005-06,G,Troy,Sun Belt,29,1003,176,394,86,157,90,237,78,106,30,124,154,192,88,3,95,53,520
2411,Rahmon Fletcher,JR,2009-10,G,Green Bay,Horizon,33,997,191,420,140,281,51,139,87,115,9,55,64,97,55,2,102,80,520
2412,Jeremy Hunt,SR,2006-07,G,Memphis,CUSA,37,885,161,386,72,153,89,233,109,152,25,83,108,50,50,13,50,70,520
2413,Courtney Lee,JR,2006-07,G,Western Kentucky,Sun Belt,30,918,187,396,130,254,57,142,89,106,45,94,139,57,45,23,83,78,520
2414,Gerald Lee,SR,2009-10,C,Old Dominion,CAA,36,1055,192,355,185,343,7,12,129,170,66,106,172,46,20,23,66,88,520
2415,E.C. Matthews,JR,2016-17,G,Rhode Island,A-10,35,1024,172,403,108,213,64,190,112,154,23,128,151,50,18,12,66,59,520
2416,Jordan Murphy,SR,2018-19,F,Minnesota,Big Ten,36,1120,174,357,166,327,8,30,164,240,118,279,397,93,21,29,79,99,520
2417,Mike Myers,SR,2014-15,F,Maryland-Eastern Shore,MEAC,33,871,169,285,168,279,1,6,181,282,87,145,232,45,39,12,105,111,520
2420,Divine Myles,SR,2017-18,G,Stetson,A-Sun,31,1076,190,381,156,272,34,109,106,145,24,115,139,130,49,4,49,53,520
2421,James Nunnally,JR,2010-11,F,UC-Santa Barbara,Big West,32,1055,167,358,105,190,62,168,124,150,22,161,183,57,14,8,68,59,520
2422,Clifford Reed,SO,2009-10,G,Bethune-Cookman,MEAC,33,1236,180,492,138,343,42,149,118,155,24,106,130,137,47,3,125,63,520
2423,Steven Rush,JR,2006-07,G,North Carolina A&T,MEAC,30,820,157,379,42,92,115,287,91,106,10,61,71,39,18,1,49,49,520
2424,Parker Smith,SR,2012-13,G,North Florida,A-Sun,32,1034,160,375,44,107,116,268,84,96,9,100,109,50,18,2,66,49,520
2425,Brandon Taylor,SR,2015-16,F,Penn State,Big Ten,32,1032,188,434,137,292,51,142,93,128,51,156,207,50,19,17,80,94,520
2426,Reed Timmer,SO,2015-16,G,Drake,MVC,31,1025,166,359,126,260,40,99,148,182,13,99,112,78,19,0,75,61,520
2427,Mike Trimboli,SO,2006-07,G,Vermont,AEC,33,1168,170,427,105,242,65,185,115,138,23,90,113,166,62,9,112,64,520
2428,Kyle Vinales,FR,2011-12,G,Central Connecticut State,NEC,29,1007,179,456,108,272,71,184,91,108,10,47,57,105,34,2,89,54,520
2429,Jordan Walker,JR,2018-19,G,Morehead State,OVC,33,1089,168,399,96,218,72,181,112,142,29,87,116,85,39,4,76,84,520
2430,Kyle Wilson,SR,2015-16,G,Army,Patriot,33,1074,175,470,75,169,100,301,70,87,12,63,75,55,13,9,58,56,520
2431,Matthew Wright,SR,2013-14,G,St. Bonaventure,A-10,32,1117,164,401,96,213,68,188,124,144,28,72,100,101,35,2,90,66,520
2432,Justin Bibbins,SR,2017-18,G,Utah,Pac-12,35,1222,154,337,61,125,93,212,118,135,13,91,104,163,45,4,71,88,519
2433,Rodney Bullock,JR,2016-17,F,Providence,Big East,33,1082,177,406,131,261,46,145,119,159,45,166,211,47,38,27,81,76,519
2434,D.J. Fenner,JR,2015-16,G,Nevada,MWC,38,1283,174,476,121,299,53,177,118,138,27,147,174,74,42,18,65,107,519
2435,Marcus Gilbert,SR,2015-16,F,Fairfield,MAAC,31,1020,165,385,87,176,78,209,111,142,24,138,162,45,29,19,67,71,519
2436,Jeremy Green,JR,2010-11,G,Stanford,Pac-10,31,1011,173,409,85,204,88,205,85,107,18,87,105,30,16,4,66,73,519
2437,Taurean Green,SO,2005-06,G,Florida,SEC,39,1302,130,355,42,126,88,229,171,193,15,100,115,184,51,5,124,63,519
2438,Montrezl Harrell,SO,2013-14,F,Louisville,AAC,37,1083,223,366,221,363,2,3,71,153,120,191,311,45,38,49,53,89,519
2439,Brandon Hazzard,JR,2008-09,G,Troy,Sun Belt,32,954,181,378,98,193,83,185,74,96,10,62,72,53,25,0,47,42,519
2442,Tyler Herro,FR,2018-19,G,Kentucky,SEC,37,1207,186,403,126,234,60,169,87,93,15,151,166,91,40,12,60,47,519
2443,Cory Jefferson,SR,2013-14,F,Baylor,Big 12,38,1103,184,368,170,330,14,38,137,214,107,205,312,37,15,49,51,83,519
2444,Chavaughn Lewis,SO,2012-13,G,Marist,MAAC,31,1090,190,453,165,379,25,74,114,182,46,130,176,85,63,17,110,82,519
2445,Aleks Maric,SR,2007-08,C,Nebraska,Big 12,33,968,191,332,190,326,1,6,136,207,131,204,335,64,44,57,79,80,519
2446,Jack McClinton,SO,2006-07,G,Miami (FL),ACC,31,976,163,403,72,196,91,207,102,114,14,63,77,66,22,1,74,70,519
2447,Kevin Pangos,JR,2013-14,G,Gonzaga,WCC,36,1239,159,370,75,166,84,204,117,134,8,110,118,128,37,1,60,70,519
2448,Kendrick Perry,JR,2012-13,G,Youngstown State,Horizon,30,1061,158,359,108,219,50,140,153,181,31,133,164,122,56,13,60,82,519
2449,Desi Rodriguez,JR,2016-17,F,Seton Hall,Big East,33,1054,192,437,142,296,50,141,85,133,43,128,171,58,27,14,69,83,519
2450,Kyle Roemer,JR,2007-08,F,Colgate,Patriot,32,1059,170,413,88,207,82,206,97,128,37,106,143,49,42,5,79,68,519
2451,JaJuan Smith,SR,2007-08,G,Tennessee,SEC,36,992,174,377,81,134,93,243,78,102,26,108,134,81,61,1,61,88,519
2452,Marques Townes,SR,2018-19,G,Loyola (IL),MVC,34,1146,192,412,153,299,39,113,96,126,17,153,170,124,36,8,76,48,519
2453,Ken Williams,SO,2014-15,G,South Alabama,Sun Belt,33,1087,165,439,78,204,87,235,102,129,13,108,121,80,24,9,76,66,519
2454,Christian Wood,SO,2014-15,F,Nevada-Las Vegas,MWC,33,1078,187,376,162,288,25,88,120,163,94,235,329,43,11,90,79,86,519
2455,Dion Wright ,SR,2015-16,F,St. Bonaventure,A-10,31,1150,199,426,175,350,24,76,97,122,90,192,282,38,30,23,45,87,519
2456,Eddie Ard,SO,2005-06,G,Lipscomb,A-Sun,32,944,187,376,146,279,41,97,103,126,54,119,173,50,58,19,99,97,518
2457,J.J. Avila,SR,2014-15,F,Colorado State,MWC,31,995,206,373,197,336,9,37,97,153,91,140,231,88,62,11,84,81,518
2458,Ike Azotam,SR,2013-14,F,Quinnipiac,MAAC,32,1068,196,408,196,407,0,1,126,201,132,195,327,31,10,35,63,90,518
2459,Mike Black,SR,2012-13,G,Albany (NY),AEC,35,1130,160,401,104,253,56,148,142,186,27,84,111,84,36,2,101,67,518
2460,James Blackmon,FR,2014-15,G,Indiana,Big Ten,33,989,177,421,100,222,77,199,87,108,53,123,176,50,21,2,53,51,518
2461,Garfield Blair,SR,2008-09,G,Stetson,A-Sun,30,987,187,432,148,322,39,110,105,147,62,170,232,63,33,18,94,75,518
2464,Tyrone Brazelton,SR,2007-08,G,Western Kentucky,Sun Belt,36,986,174,389,105,228,69,161,101,150,21,78,99,134,39,2,101,108,518
2465,De'Mon Brooks,SO,2011-12,F,Davidson,Southern,33,752,202,381,181,324,21,57,93,129,80,126,206,26,33,17,56,107,518
2466,Mike Caffey,JR,2013-14,G,Long Beach State,Big West,32,1106,185,452,143,307,42,145,106,160,51,90,141,136,45,4,98,66,518
2467,Ajay Calvin,SR,2006-07,F,Drake,MVC,32,1043,208,405,191,353,17,52,85,126,80,116,196,25,21,5,55,53,518
2468,Brandon Clarke,SO,2016-17,F,San Jose State,MWC,30,957,219,370,218,367,1,3,79,138,89,172,261,69,35,77,53,78,518
2469,Karl Cochran,JR,2013-14,G,Wofford,Southern,33,1011,193,465,115,261,78,204,54,80,20,144,164,100,55,19,64,74,518
2470,Mike Daum,FR,2015-16,F,South Dakota State,Summit,34,706,172,311,143,246,29,65,145,176,71,136,207,27,17,11,56,71,518
2471,Dontaye Draper,JR,2005-06,G,College of Charleston,Southern,28,985,180,416,118,230,62,186,96,131,24,48,72,90,62,12,97,73,518
2472,Malik Fitts,SO,2018-19,F,Saint Mary's (CA),WCC,34,1045,183,385,125,242,58,143,94,122,61,196,257,32,39,7,53,95,518
2473,Chris Fowler,JR,2014-15,G,Central Michigan,MAC,32,1093,183,361,163,295,20,66,132,194,16,83,99,194,49,7,91,77,518
2474,Kellan Grady,SO,2018-19,G,Davidson,A-10,30,1127,194,430,136,260,58,170,72,98,12,122,134,57,31,5,50,46,518
2475,Dusty Hannahs,SR,2016-17,G,Arkansas,SEC,36,890,168,383,94,192,74,191,108,119,20,42,62,43,16,4,60,63,518
2476,Venky Jois,JR,2014-15,F,Eastern Washington,Big Sky,31,966,210,344,207,334,3,10,95,176,82,156,238,63,37,69,71,75,518
2477,MoMo Jones,JR,2011-12,G,Iona,MAAC,33,1132,197,429,144,279,53,150,71,91,25,83,108,95,40,2,71,64,518
2478,Tyler Kohl,JR,2017-18,G,Central Connecticut State,NEC,31,1080,180,427,137,279,43,148,115,146,59,195,254,128,42,4,114,61,518
2479,Nate Mason,JR,2016-17,G,Minnesota,Big Ten,34,1174,169,450,115,300,54,150,126,156,22,102,124,169,46,4,65,55,518
2480,James Michael McAdoo,SO,2012-13,F,North Carolina,ACC,36,1079,209,470,209,468,0,2,100,173,89,174,263,41,54,14,96,84,518
2481,Ben McCauley,SO,2006-07,F,North Carolina State,ACC,36,1243,211,361,211,359,0,2,96,147,86,161,247,115,36,22,90,97,518
2482,Jordan McRae,JR,2012-13,G,Tennessee,SEC,33,1107,170,402,110,233,60,169,118,153,31,105,136,66,26,29,93,77,518
2483,Markieff Morris,JR,2010-11,C,Kansas,Big 12,38,926,195,331,170,272,25,59,103,153,103,213,316,53,30,43,78,108,518
2484,Chamberlain Oguchi,SR,2008-09,G,Illinois State,MVC,34,1076,162,394,72,165,90,229,104,127,34,151,185,44,34,14,52,86,518
2485,Anthony Raffa,JR,2011-12,G,Coastal Carolina,Big South,31,962,184,383,139,257,45,126,105,144,42,74,116,63,57,2,67,71,518
2486,DeWayne Reed,SR,2009-10,G,Auburn,SEC,32,1059,167,426,118,276,49,150,135,190,13,70,83,139,43,7,102,69,518
2487,Marcellus Sommerville,SR,2005-06,F,Bradley,MVC,33,1050,183,450,124,286,59,164,93,119,68,158,226,23,26,13,78,82,518
2488,Steven Spieth,SR,2016-17,F,Brown,Ivy,30,1037,153,314,103,191,50,123,162,184,43,137,180,100,43,11,101,85,518
2489,Malik Story,SR,2012-13,G,Nevada,MWC,31,1027,173,425,90,193,83,232,89,120,6,99,105,69,36,3,73,84,518
2490,Frank Turner,SR,2009-10,G,Canisius,MAAC,32,1226,172,365,149,294,23,71,151,211,24,139,163,182,66,3,106,80,518
2491,Lindell Wigginton,FR,2017-18,G,Iowa State,Big 12,31,1022,171,413,102,241,69,172,107,162,20,96,116,88,28,13,92,78,518
2492,Michael Young,JR,2015-16,F,Pittsburgh,ACC,33,971,189,352,185,340,4,12,136,175,76,152,228,77,11,18,81,54,518
2493,Nick Young,SO,2005-06,F,Southern California,Pac-10,30,1017,191,409,168,340,23,69,113,141,74,124,198,49,31,7,67,77,518
2494,Scott Bamforth,SR,2012-13,G,Weber State,Big Sky,37,1150,163,337,60,111,103,226,88,102,7,135,142,87,38,2,47,64,517
2495,Ryan Broekhoff,SR,2012-13,G,Valparaiso,Horizon,33,1062,158,353,75,154,83,199,118,134,40,200,240,75,34,27,64,46,517
2496,Darrell Brown,JR,2018-19,G,Bradley,MVC,35,1178,164,416,85,238,79,178,110,149,7,60,67,111,33,3,84,74,517
2497,Deonte Burton,SO,2011-12,G,Nevada,WAC,35,1152,147,366,89,210,58,156,165,207,13,78,91,148,38,13,71,82,517
2498,Eric Devendorf,SO,2006-07,G,Syracuse,Big East,35,1081,172,417,118,264,54,153,119,150,15,79,94,145,43,11,109,93,517
2499,Weyinmi Efejuku,SR,2008-09,G,Providence,Big East,33,974,165,353,125,250,40,103,147,186,46,86,132,77,48,7,74,52,517
2500,Muhammad El-Amin,SR,2009-10,G,Stony Brook,AEC,31,942,180,448,125,290,55,158,102,128,28,76,104,59,33,5,71,65,517
2501,Brandon Ewing,JR,2007-08,G,Wyoming,MWC,30,1140,162,376,102,208,60,168,133,161,18,89,107,121,38,3,103,64,517
2502,Ethan Happ,SO,2016-17,F,Wisconsin,Big Ten,37,1033,218,372,218,372,0,0,81,162,117,215,332,104,67,43,80,102,517
2503,Chris Hass,SR,2015-16,G,Bucknell,Patriot,30,945,163,385,103,203,60,182,131,158,24,97,121,48,34,14,63,65,517
2506,Nigel Hayes,SR,2016-17,F,Wisconsin,Big Ten,37,1190,180,394,158,324,22,70,135,230,82,163,245,100,28,14,63,67,517
2507,Derrick Henry,SR,2015-16,G,Citadel,Southern,32,838,152,358,111,218,41,140,172,218,34,96,130,43,37,0,51,63,517
2508,Travis Holmes,SR,2008-09,F,Virginia Military Institute,Big South,27,850,172,346,136,227,36,119,137,174,38,128,166,117,87,17,81,73,517
2509,Chris Lofton,SO,2005-06,G,Tennessee,SEC,30,957,174,373,60,112,114,261,55,60,30,76,106,56,60,3,36,55,517
2510,Chris Lykes,SO,2018-19,G,Miami (FL),ACC,32,1082,171,421,110,229,61,192,114,146,14,72,86,103,43,1,93,72,517
2511,Kelan Martin,SO,2015-16,F,Butler,Big East,33,935,183,409,137,287,46,122,105,138,52,172,224,36,25,18,54,88,517
2512,Nate Mason,SR,2017-18,G,Minnesota,Big Ten,31,1057,168,428,91,231,77,197,104,134,18,95,113,130,34,2,47,60,517
2513,Ramone Moore,JR,2010-11,G,Temple,A-10,34,1151,178,398,137,291,41,107,120,151,25,118,143,105,40,8,82,64,517
2514,Nile Murry,SR,2005-06,G,Texas Christian,MWC,31,1048,157,422,90,239,67,183,136,165,45,86,131,82,53,2,87,86,517
2515,Matt Nelson,SR,2007-08,F,Boise State,WAC,33,971,202,312,202,311,0,1,113,181,82,159,241,70,21,8,74,98,517
2516,Marcus Posley,JR,2014-15,G,St. Bonaventure,A-10,31,1114,170,445,94,209,76,236,101,129,14,77,91,66,38,1,64,71,517
2517,Mike Rosario,FR,2008-09,G,Rutgers,Big East,32,1040,184,470,108,218,76,252,73,87,39,72,111,45,34,6,94,74,517
2518,Alex Ruoff,SR,2008-09,G,West Virginia,Big East,33,1176,165,384,77,148,88,236,99,124,29,89,118,112,55,11,69,80,517
2519,Corey Sanders,JR,2017-18,G,Rutgers,Big Ten,34,1127,205,511,183,413,22,98,85,120,18,129,147,106,44,9,76,54,517
2520,John Caleb Sanders,JR,2012-13,G,Liberty,Big South,36,1088,165,385,120,259,45,126,142,183,41,100,141,131,34,3,95,94,517
2521,Justin Simmons,JR,2012-13,G,Omaha,Summit,31,879,196,414,153,307,43,107,82,105,26,99,125,64,37,20,93,42,517
2522,Ivy Smith Jr.,SO,2017-18,G,Grambling,SWAC,31,1089,149,373,124,304,25,69,194,241,25,114,139,154,67,5,110,94,517
2523,Jonathan Tavernari,JR,2008-09,F,Brigham Young,MWC,33,1042,195,451,110,228,85,223,42,55,34,205,239,58,49,11,44,77,517
2524,Darius Thompson,SR,2017-18,G,Western Kentucky,CUSA,38,1354,177,382,123,230,54,152,109,148,23,136,159,181,58,18,66,69,517
2525,B.A. Walker,SR,2006-07,G,Virginia Commonwealth,CAA,35,1131,179,389,87,167,92,222,67,79,32,69,101,66,35,7,43,66,517
2528,Rashad West,SR,2007-08,G,Hampton,MEAC,30,945,160,421,98,227,62,194,135,187,20,73,93,86,39,0,102,49,517
2529,Isaiah Wilkerson,SR,2011-12,F,NJIT,GWC,32,994,179,412,135,294,44,118,115,141,87,125,212,66,56,6,53,89,517
2530,Chris Wright,JR,2009-10,G,Georgetown,Big East,34,1194,183,389,140,261,43,128,108,139,18,83,101,138,51,9,77,76,517
2531,Ron Baker,JR,2014-15,G,Wichita State,MVC,35,1145,171,395,91,186,80,209,94,124,31,126,157,88,45,27,39,60,516
2532,Keith Benson,SO,2008-09,C,Oakland,Summit,36,999,191,307,191,306,0,1,134,201,92,188,280,25,20,87,38,116,516
2533,Michael Buchanan,SR,2016-17,C,South Carolina Upstate,A-Sun,32,744,207,332,207,332,0,0,102,193,117,187,304,37,17,20,71,86,516
2534,T.T. Carey,JR,2012-13,G,Longwood,Big South,33,1126,189,446,108,224,81,222,57,79,30,138,168,58,73,19,62,76,516
2535,Kameron Chatman,JR,2017-18,G,Detroit Mercy,Horizon,29,945,183,388,123,243,60,145,90,106,41,199,240,60,36,11,59,75,516
2536,Cameron Clark,SR,2013-14,G,Oklahoma,Big 12,33,915,190,411,153,326,37,85,99,124,44,139,183,37,34,13,43,87,516
2537,Xavier Cooks,SR,2017-18,G,Winthrop,Big South,30,894,194,385,173,319,21,66,107,160,64,199,263,108,30,64,98,72,516
2538,Keith Cothran,SR,2009-10,G,Rhode Island,A-10,36,1101,189,443,145,304,44,139,94,138,45,79,124,75,61,17,53,59,516
2539,Allen Crabbe,SO,2011-12,G,University of California,Pac-12,34,1158,179,415,96,207,83,208,75,89,32,162,194,71,18,20,53,48,516
2540,Noah Dahlman,SO,2008-09,F,Wofford,Southern,29,873,193,321,193,317,0,4,130,182,99,86,185,14,21,10,37,53,516
2541,Aubrey Dawkins,JR,2018-19,G,Central Florida,AAC,33,1101,181,391,108,210,73,181,81,97,33,133,166,46,34,10,54,73,516
2542,Nick Garth,SR,2018-19,G,Lamar,Southland,31,964,167,394,85,174,82,220,100,119,11,63,74,73,38,3,47,71,516
2543,Kyle Gibson,JR,2008-09,G,Louisiana Tech,WAC,32,1144,154,343,78,168,76,175,132,180,27,88,115,88,33,6,97,74,516
2544,Manny Harris,FR,2007-08,G,Michigan,Big Ten,32,1057,159,417,117,285,42,132,156,191,34,101,135,86,45,7,115,65,516
2545,Stephen Holt ,SR,2013-14,G,Saint Mary's (CA),WCC,34,1275,148,328,90,197,58,131,162,195,39,89,128,134,26,0,65,79,516
2546,Stefan Jankovic,JR,2015-16,F,Hawaii,Big West,33,817,172,317,139,233,33,84,139,180,57,161,218,39,20,40,58,100,516
2547,Killian Larson,SR,2013-14,C,Grand Canyon,WAC,30,980,180,333,179,330,1,3,155,210,115,233,348,24,14,6,76,96,516
2550,Maodo Lo,JR,2014-15,G,Columbia,Ivy,28,957,181,370,97,175,84,195,70,91,13,109,122,65,43,16,69,62,516
2551,Tymell Murphy,SR,2013-14,F,Florida International,CUSA,31,1066,198,338,185,292,13,46,107,163,67,163,230,70,60,47,91,90,516
2552,Ahmad Nivins,SO,2006-07,F,Saint Joseph's,A-10,31,1105,176,279,176,278,0,1,164,242,105,130,235,11,32,32,77,89,516
2553,Elijah Pittman,JR,2012-13,F,Marshall,CUSA,32,1032,169,348,104,173,65,175,113,161,50,85,135,50,24,24,77,70,516
2554,Justin Robinson,SR,2010-11,G,Rider,MAAC,34,1141,164,386,76,180,88,206,100,110,13,84,97,130,35,4,89,69,516
2555,Nike Sibande,SO,2018-19,G,Miami (OH),MAC,32,960,165,419,89,188,76,231,110,158,28,134,162,38,27,13,64,61,516
2556,Andrew Strait,SO,2005-06,F,Montana,Big Sky,31,1001,223,363,221,360,2,3,68,112,68,129,197,47,19,27,45,54,516
2557,Demetrius Treadwell,SR,2013-14,F,Akron,MAC,34,1131,181,395,180,385,1,10,153,253,113,180,293,63,33,29,85,60,516
2558,Valdas Vasylius,SR,2006-07,F,Old Dominion,CAA,33,885,158,325,133,249,25,76,175,231,75,125,200,31,22,16,58,92,516
2559,Jamarco Warren,SO,2008-09,G,Charleston Southern,Big South,29,959,168,408,69,159,99,249,81,105,10,70,80,82,27,2,68,63,516
2560,Chaz Williams,SR,2013-14,G,Massachusetts,A-10,33,1163,162,402,108,253,54,149,138,183,27,65,92,229,52,7,113,97,516
2561,Curtis Withers,SR,2005-06,F,Charlotte,A-10,32,1088,181,403,163,343,18,60,136,234,136,226,362,80,32,28,100,99,516
2562,Bryce Alford,JR,2015-16,G,UCLA,Pac-12,32,1159,157,408,84,209,73,199,128,154,9,113,122,167,23,0,63,41,515
2563,Donte Clark,SO,2015-16,G,Massachusetts,A-10,32,995,157,383,95,200,62,183,139,185,19,103,122,73,28,9,71,105,515
2564,Jordan Downing,SR,2014-15,G,Presbyterian,Big South,31,1007,184,445,115,251,69,194,78,102,21,112,133,36,19,5,63,67,515
2565,Kris Dunn,SO,2014-15,G,Providence,Big East,33,1123,185,390,158,313,27,77,118,172,28,152,180,247,90,10,138,101,515
2566,Bryant Dunston,SO,2005-06,F,Fordham,A-10,32,1003,174,325,155,286,19,39,148,220,83,159,242,52,26,76,79,103,515
2567,Al Fisher,SR,2008-09,G,Kent State,MAC,34,1089,172,424,127,285,45,139,126,149,17,98,115,120,56,4,112,77,515
2568,Martez Harrison,FR,2013-14,G,Missouri-Kansas City,WAC,30,973,159,362,126,270,33,92,164,257,22,78,100,114,50,0,92,89,515
2569,Frank Hassell,SR,2010-11,F,Old Dominion,CAA,34,997,196,350,196,349,0,1,123,167,127,194,321,38,29,43,70,61,515
2572,Ian Hummer,JR,2011-12,F,Princeton,Ivy,32,1028,190,407,171,347,19,60,116,173,69,166,235,101,46,39,89,70,515
2573,James Johnson,JR,2010-11,G,Quinnipiac,NEC,32,1086,176,442,92,224,84,218,79,97,29,104,133,112,51,2,48,69,515
2574,Jason McLeish,SR,2005-06,G,Eastern Kentucky,OVC,29,920,168,338,111,219,57,119,122,151,31,47,78,58,43,6,63,59,515
2575,Jonathon Modica,SR,2005-06,G,Arkansas,SEC,32,990,178,376,123,219,55,157,104,142,58,70,128,53,36,1,66,50,515
2576,A.J. Price,SR,2008-09,G,Connecticut,Big East,35,1112,170,417,88,213,82,204,93,129,20,102,122,164,24,0,94,44,515
2577,Malcolm Riley ,SR,2015-16,F,Texas Southern,SWAC,33,1051,173,383,96,173,77,210,92,117,53,135,188,29,15,5,48,64,515
2578,Nike Sibande,FR,2017-18,G,Miami (OH),MAC,34,1117,171,413,94,193,77,220,96,131,28,118,146,42,39,5,72,63,515
2579,Isaiah Sykes,SR,2013-14,G,Central Florida,AAC,30,958,198,417,186,385,12,32,107,198,88,129,217,105,51,5,110,80,515
2580,Jaylin Walker,JR,2017-18,G,Kent State,MAC,31,1043,171,450,87,194,84,256,89,113,38,82,120,62,32,4,80,49,515
2581,Wink Adams,SO,2006-07,G,Nevada-Las Vegas,MWC,37,1147,165,430,98,243,67,187,117,155,37,105,142,85,55,5,71,74,514
2582,Seth Allen,JR,2015-16,G,Virginia Tech,ACC,35,985,150,381,106,224,44,157,170,219,9,97,106,88,33,9,102,79,514
2583,Nick Barbour,JR,2010-11,G,High Point,Big South,29,865,160,395,92,207,68,188,126,160,15,71,86,30,28,3,68,84,514
2584,Kyle Barone,SR,2012-13,C,Idaho,WAC,30,1021,178,299,178,298,0,1,158,202,100,191,291,54,10,36,57,69,514
2585,Matt Bouldin,SR,2009-10,G,Gonzaga,WCC,33,1176,165,366,108,210,57,156,127,148,15,139,154,132,46,6,75,70,514
2586,De'Mon Brooks,SR,2013-14,F,Davidson,Southern,27,724,173,295,159,264,14,31,154,207,60,131,191,37,18,22,60,94,514
2587,Richard Carter,SR,2013-14,G,Drake,MVC,31,969,157,367,115,237,42,130,158,214,16,82,98,117,55,0,76,75,514
2588,Nico Carvacho,JR,2018-19,C,Colorado State,MWC,32,1021,216,365,216,363,0,2,82,167,125,287,412,67,19,21,68,88,514
2589,Will Clyburn,JR,2010-11,G,Utah,MWC,30,1040,163,362,101,208,62,154,126,166,51,182,233,31,34,7,75,68,514
2590,Marvin Dominique,JR,2013-14,F,Saint Peter's,MAAC,31,1040,190,400,156,301,34,99,100,133,92,183,275,20,29,27,72,81,514
2591,Corey Fisher,SR,2010-11,G,Villanova,Big East,33,1101,165,394,113,235,52,159,132,168,19,72,91,159,49,2,75,78,514
2592,Jerome Frink,JR,2015-16,F,Long Island University,NEC,31,1006,197,392,160,294,37,98,83,124,96,182,278,39,39,39,83,97,514
2593,C.J. Garner,SR,2012-13,G,Long Island University,NEC,32,1121,180,358,153,297,27,61,127,175,43,89,132,80,51,11,68,52,514
2594,Isaac Haas,SR,2017-18,C,Purdue,Big Ten,35,818,185,300,185,300,0,0,144,190,60,141,201,26,5,46,58,85,514
2595,Randal Holt,SR,2012-13,G,Kent State,MAC,35,1132,164,433,75,202,89,231,97,114,21,90,111,84,44,3,77,53,514
2596,Peter Jok,JR,2015-16,G,Iowa,Big Ten,32,887,171,397,91,198,80,199,92,108,28,84,112,46,40,1,46,76,514
2597,Tim Kempton,JR,2015-16,C,Lehigh,Patriot,29,864,182,328,177,312,5,16,145,192,69,207,276,41,20,13,84,90,514
2598,Austin Kenon,SR,2010-11,G,Virginia Military Institute,Big South,28,841,151,345,58,123,93,222,119,141,27,70,97,91,27,1,55,61,514
2599,Ross Mouton,SR,2006-07,G,Louisiana,Sun Belt,30,979,190,459,122,271,68,188,66,91,41,94,135,45,17,7,67,63,514
2600,Matt Murrer,SR,2006-07,F,Virginia Military Institute,Big South,31,860,195,386,132,184,63,202,61,80,61,118,179,30,28,58,41,105,514
2601,Jordan Parks,SR,2014-15,G,North Carolina Central,MEAC,33,1042,212,321,206,305,6,16,84,126,87,186,273,22,35,31,61,98,514
2602,Rico Pickett,JR,2009-10,G,Manhattan,MAAC,29,912,201,457,153,313,48,144,64,90,32,81,113,29,38,6,59,63,514
2603,Victor Rudd,SR,2013-14,F,South Florida,AAC,32,1085,180,431,147,304,33,127,121,164,21,197,218,59,19,18,69,69,514
2604,Amu Saaka,SR,2010-11,F,Furman,Southern,33,1043,167,362,117,223,50,139,130,149,68,145,213,35,24,10,58,84,514
2605,Josh Slater,JR,2009-10,G,Lipscomb,A-Sun,30,922,157,345,114,229,43,116,157,225,54,109,163,155,58,11,87,65,514
2606,D.J. Thompson,SR,2006-07,G,Appalachian State,Southern,33,1075,153,390,71,172,82,218,126,161,25,83,108,163,85,1,99,67,514
2607,Matt Tiby,SR,2015-16,F,Milwaukee,Horizon,33,993,155,340,112,225,43,115,161,195,60,212,272,66,11,10,68,78,514
2608,Cameron Wells,SO,2008-09,G,Citadel,Southern,33,1137,190,415,165,336,25,79,109,135,26,135,161,100,44,14,88,75,514
2609,Derek Williams,SR,2009-10,G,Southern Methodist,CUSA,31,1129,168,384,130,260,38,124,140,185,15,83,98,114,29,3,76,56,514
2610,Reggie Williams,SO,2005-06,F,Virginia Military Institute,Big South,27,893,172,372,128,233,44,139,126,168,53,135,188,69,27,4,76,45,514
2611,Jeff Xavier,SO,2005-06,G,Manhattan,MAAC,31,1080,179,412,102,192,77,220,79,99,49,133,182,60,70,7,78,82,514
2614,Anthony Adger,SR,2018-19,G,Florida Atlantic,CUSA,33,1068,154,423,61,152,93,271,112,136,20,120,140,85,33,2,69,53,513
2615,Rion Brown,SR,2013-14,G,Miami (FL),ACC,33,1167,174,403,111,204,63,199,102,135,47,146,193,76,27,4,51,62,513
2616,Dane Brumagin,JR,2007-08,F,Missouri-Kansas City,Summit,30,889,168,364,89,189,79,175,98,113,53,90,143,36,38,1,57,94,513
2617,Marqueze Coleman,SR,2015-16,G,Nevada,MWC,34,1003,151,369,121,272,30,97,181,243,24,121,145,111,41,5,88,92,513
2618,Dave Dudzinski,SR,2013-14,F,Holy Cross,Patriot,34,1057,184,393,158,319,26,74,119,157,87,164,251,21,24,26,65,82,513
2619,Scott Eatherton,SR,2014-15,F,Northeastern,CAA,35,1054,197,333,189,302,8,31,111,160,63,161,224,53,19,43,71,92,513
2620,Osiris Eldridge,SR,2009-10,G,Illinois State,MVC,33,1102,173,432,100,226,73,206,94,118,24,109,133,83,50,11,84,71,513
2621,Marcus Foster,FR,2013-14,G,Kansas State,Big 12,33,969,177,418,98,218,79,200,80,109,26,80,106,84,19,7,73,79,513
2622,Tony Gallo,SR,2011-12,G,Coppin State,MEAC,30,1015,149,375,69,149,80,226,135,178,9,72,81,112,40,2,66,64,513
2623,Kenny Hasbrouck,SO,2006-07,G,Siena,MAAC,32,979,182,383,141,271,41,112,108,137,22,61,83,84,50,4,84,78,513
2624,Adnan Hodzic,SO,2008-09,C,Lipscomb,A-Sun,30,810,210,358,210,358,0,0,93,125,69,143,212,20,10,8,87,70,513
2625,James Johnson,SR,2011-12,G,Quinnipiac,NEC,31,1119,173,454,104,265,69,189,98,133,20,81,101,108,39,4,77,73,513
2626,DeAndre Kane,SO,2010-11,G,Marshall,CUSA,34,1076,170,397,121,243,49,154,124,196,40,149,189,117,32,3,115,99,513
2627,Loudon Love,SO,2018-19,C,Wright State,Horizon,34,918,209,420,209,420,0,0,95,152,120,160,280,33,20,32,81,93,513
2628,Bryant McAllister,SR,2005-06,G,Duquesne,A-10,26,874,160,378,108,239,52,139,141,174,18,73,91,125,33,2,96,57,513
2629,Malcolm Miller,SO,2012-13,G,Southern,SWAC,33,863,184,364,94,165,90,199,55,77,46,148,194,28,39,21,33,64,513
2630,Divine Myles,JR,2016-17,G,Stetson,A-Sun,31,1045,189,372,159,294,30,78,105,147,26,120,146,122,29,3,65,63,513
2631,Damier Pitts,SR,2011-12,G,Marshall,CUSA,35,1191,180,433,108,221,72,212,81,114,18,66,84,149,36,2,111,87,513
2632,Jordan Potts,JR,2015-16,G,Bethune-Cookman,MEAC,32,1207,156,448,71,183,85,265,116,149,19,82,101,138,50,3,90,76,513
2633,Chris Quinn,SR,2005-06,G,Notre Dame,Big East,29,1160,174,387,104,220,70,167,95,109,24,85,109,187,45,3,77,61,513
2636,Josh Richardson,SR,2014-15,G,Tennessee,SEC,32,1162,184,399,138,271,46,128,99,124,28,115,143,115,67,16,85,79,513
2637,Jaelan Sanford,SR,2018-19,G,Toledo,MAC,33,1104,192,452,138,285,54,167,75,89,31,108,139,106,12,5,61,55,513
2638,A.J. Slaughter,JR,2008-09,G,Western Kentucky,Sun Belt,32,1107,171,410,99,212,72,198,99,129,21,78,99,114,43,1,68,57,513
2639,Jimmie Taylor,SR,2016-17,G,Rider,MAAC,33,1180,170,399,103,214,67,185,106,141,46,115,161,61,37,9,48,86,513
2640,Colton Weisbrod,JR,2016-17,F,Lamar,Southland,34,1066,177,339,176,333,1,6,158,222,89,186,275,31,19,7,87,75,513
2641,Delon Wright,JR,2013-14,G,Utah,Pac-12,33,1202,174,310,162,256,12,54,153,193,42,182,224,174,82,43,84,61,513
2642,Peyton Aldridge,SO,2015-16,F,Davidson,A-10,33,1143,179,364,130,231,49,133,105,124,68,147,215,74,19,33,47,86,512
2643,Trevon Bluiett,SO,2015-16,F,Xavier,Big East,34,1042,170,401,92,205,78,196,94,122,49,160,209,74,31,11,56,79,512
2644,Roy Bright,JR,2006-07,F,Delaware State,MEAC,33,1170,187,425,130,251,57,174,81,102,50,111,161,33,27,18,56,60,512
2645,Alec Burks,FR,2009-10,G,Colorado,Big 12,30,907,172,320,153,266,19,54,149,193,58,92,150,53,35,12,58,74,512
2646,Glen Davis,JR,2006-07,F,Louisiana State,SEC,29,1016,178,368,161,319,17,49,139,195,113,190,303,66,32,28,82,67,512
2647,Matthew Dellavedova,JR,2011-12,G,Saint Mary's (CA),WCC,33,1236,157,352,97,183,60,169,138,161,19,90,109,212,28,2,96,57,512
2648,Mikey Dixon,FR,2016-17,G,Quinnipiac,MAAC,31,924,171,377,111,215,60,162,110,128,35,81,116,72,23,2,68,59,512
2649,Jordan Dykstra,SR,2013-14,F,South Dakota State,Summit,32,1021,156,344,105,217,51,127,149,178,56,186,242,60,20,6,55,82,512
2650,Zach Filzen,JR,2010-11,G,Buffalo,MAC,34,1150,178,426,68,159,110,267,46,54,9,91,100,39,26,0,57,40,512
2651,Will Franklin,SR,2006-07,G,Bradley,MVC,35,1225,174,411,86,208,88,203,76,93,26,76,102,140,48,0,69,48,512
2652,Kenny Hasbrouck,SR,2008-09,G,Siena,MAAC,35,1078,192,472,135,308,57,164,71,108,25,96,121,99,69,6,80,68,512
2653,Cameron Healy,FR,2018-19,G,Albany (NY),AEC,32,1103,166,393,62,142,104,251,76,86,11,110,121,78,22,3,70,54,512
2654,Peter Hooley,SO,2013-14,G,Albany (NY),AEC,33,1157,143,359,72,176,71,183,155,182,10,79,89,87,27,0,67,51,512
2655,Xavier Johnson,FR,2018-19,G,Pittsburgh,ACC,33,1028,159,383,122,278,37,105,157,209,38,90,128,149,43,4,132,89,512
2658,Andre Jones,SR,2011-12,G,Winthrop,Big South,32,1109,182,421,129,265,53,156,95,119,21,81,102,54,37,9,77,66,512
2659,Kevin Jones,SO,2009-10,F,West Virginia,Big East,38,1254,199,382,157,278,42,104,72,109,135,137,272,41,22,34,41,70,512
2660,Jamaal King,SR,2018-19,G,Saint Francis (PA),NEC,33,1058,176,403,122,255,54,148,106,141,10,65,75,134,51,1,88,75,512
2661,Khris Lane,JR,2016-17,F,Longwood,Big South,30,1034,208,387,176,292,32,95,64,93,49,169,218,37,24,34,69,83,512
2662,Cameron Long,SR,2010-11,G,George Mason,CAA,34,1121,181,378,121,239,60,139,90,120,40,119,159,97,47,8,67,56,512
2663,Mark Lyons,JR,2011-12,G,Xavier,A-10,34,1086,176,414,118,266,58,148,102,134,10,100,110,94,45,10,74,96,512
2664,E'Twaun Moore,SO,2008-09,G,Purdue,Big Ten,37,1222,188,445,132,279,56,166,80,105,39,131,170,111,40,16,97,91,512
2665,Juwan Morgan,JR,2017-18,F,Indiana,Big Ten,31,912,195,337,179,284,16,53,106,168,84,144,228,47,37,44,51,77,512
2666,Brian Parker,JR,2017-18,G,Marist,MAAC,30,972,165,350,136,260,29,90,153,216,27,132,159,101,14,3,121,75,512
2667,Tajuan Porter,FR,2006-07,G,Oregon,Pac-10,35,1140,161,391,51,139,110,252,80,88,14,54,68,71,29,0,88,54,512
2668,Nik Raivio,JR,2008-09,G,Portland,WCC,32,989,181,398,132,262,49,136,101,150,44,165,209,76,40,6,71,66,512
2669,Chasson Randle,FR,2011-12,G,Stanford,Pac-12,37,1127,169,385,84,191,85,194,89,117,21,98,119,76,42,2,83,111,512
2670,Alex Ruoff,JR,2007-08,G,West Virginia,Big East,37,1179,169,353,71,114,98,239,76,92,32,96,128,103,57,12,62,77,512
2671,David Schneider,SR,2009-10,G,William & Mary,CAA,33,1099,148,425,49,136,99,289,117,146,38,159,197,97,48,2,49,76,512
2672,Sean Singletary,SO,2005-06,G,Virginia,ACC,29,982,168,420,117,273,51,147,125,148,34,94,128,121,54,3,104,65,512
2673,Anthony Smith,JR,2007-08,G,Liberty,Big South,32,1097,189,367,105,162,84,205,50,81,37,124,161,36,32,6,49,70,512
2674,Tyler Stone,JR,2012-13,F,Southeast Missouri State,OVC,33,1063,205,417,194,371,11,46,91,115,57,200,257,39,25,43,50,72,512
2675,Mike Trimboli,SR,2008-09,G,Vermont,AEC,32,1130,163,356,114,221,49,135,137,171,33,82,115,153,63,2,87,77,512
2676,James Blackmon,JR,2016-17,G,Indiana,Big Ten,30,915,174,365,83,150,91,215,72,86,29,115,144,56,21,1,58,54,511
2677,Jahsha Bluntt,JR,2005-06,G,Delaware State,MEAC,35,1245,165,400,74,167,91,233,90,119,50,117,167,41,39,12,62,73,511
2680,Jordan Clarkson,SO,2011-12,G,Tulsa,CUSA,31,1052,167,384,124,269,43,115,134,171,35,85,120,79,29,17,83,73,511
2681,Ryan Daly,FR,2016-17,G,Delaware,CAA,32,1072,189,445,127,262,62,183,71,104,67,171,238,66,27,8,39,66,511
2682,Johnny Dee,SO,2012-13,G,San Diego,WCC,34,1062,172,396,92,184,80,212,87,98,18,88,106,32,26,1,45,49,511
2683,Rob Edwards,SO,2016-17,G,Cleveland State,Horizon,31,964,167,404,104,226,63,178,114,149,29,110,139,53,41,5,95,68,511
2684,Vince Edwards,SR,2017-18,F,Purdue,Big Ten,35,1106,180,378,129,250,51,128,100,120,71,188,259,101,18,21,71,62,511
2685,Carrick Felix,SR,2012-13,G,Arizona State,Pac-12,35,1235,189,378,137,239,52,139,81,122,73,212,285,57,50,39,70,105,511
2686,Brian Fisk,JR,2005-06,G,Lipscomb,A-Sun,32,1011,182,425,133,293,49,132,98,126,28,97,125,98,59,9,93,69,511
2687,Nana Foulland,JR,2016-17,C,Bucknell,Patriot,34,938,203,322,203,322,0,0,105,187,77,187,264,41,26,72,71,95,511
2688,Troy Gillenwater,JR,2010-11,F,New Mexico State,WAC,27,818,173,377,136,275,37,102,128,171,40,130,170,16,11,26,61,60,511
2689,David Gonzalvez,SR,2009-10,G,Richmond,A-10,35,1208,171,379,95,171,76,208,93,132,27,121,148,82,65,8,57,74,511
2690,Javontae Hawkins,JR,2015-16,G,Eastern Kentucky,OVC,30,866,182,363,149,264,33,99,114,149,40,103,143,63,29,13,82,95,511
2691,Eric Hicks,SR,2005-06,F,Cincinnati,Big East,34,1169,192,401,179,374,13,27,114,173,148,181,329,29,19,113,53,78,511
2692,Stephan Hicks,SR,2014-15,G,Cal State Northridge,Big West,32,1072,167,333,151,293,16,40,161,198,61,112,173,46,30,15,60,75,511
2693,Matt Lander,SR,2010-11,G,Western Illinois,Summit,30,1085,153,373,112,250,41,123,164,215,8,62,70,80,28,7,93,65,511
2694,Shawn Long,FR,2012-13,F,Louisiana,Sun Belt,33,1025,195,453,162,347,33,106,88,127,102,235,337,32,27,65,86,95,511
2695,Josh Mayo,SR,2008-09,G,Illinois-Chicago,Horizon,30,1063,160,407,88,221,72,186,119,138,19,62,81,102,34,1,73,55,511
2696,John Murry,SR,2016-17,G,Austin Peay,OVC,30,908,165,346,124,227,41,119,140,173,15,66,81,46,22,3,73,49,511
2697,Derek Needham,SR,2012-13,G,Fairfield,MAAC,35,1157,175,440,97,201,78,239,83,108,20,99,119,110,48,2,94,97,511
2698,Cameron Oliver,FR,2015-16,F,Nevada,MWC,38,1118,201,396,181,335,20,61,89,134,103,242,345,30,23,99,79,116,511
2699,Romero Osby,SR,2012-13,F,Oklahoma,Big 12,32,912,174,331,165,314,9,17,154,194,66,159,225,40,20,27,42,78,511
2700,Gary Payton,SR,2015-16,G,Oregon State,Pac-12,32,1096,205,422,183,352,22,70,79,123,77,174,251,161,80,16,74,85,511
2701,Casey Prather,SR,2013-14,F,Florida,SEC,37,1034,190,315,188,310,2,5,129,190,72,112,184,60,37,20,80,78,511
2702,Keith Rendelman,SR,2012-13,F,North Carolina-Wilmington,CAA,30,1017,187,347,179,326,8,21,129,218,126,188,314,22,53,47,62,99,511
2703,Wes Washpun,SR,2015-16,G,Northern Iowa,MVC,36,1241,177,379,151,290,26,89,131,182,9,138,147,190,42,25,93,94,511
2704,Jaytornah Wisseh,SR,2009-10,G,Long Island University,NEC,29,1045,159,402,129,299,30,103,163,196,21,100,121,164,45,1,122,55,511
2705,Desmond Yates,SO,2007-08,F,Middle Tennessee,Sun Belt,32,1022,200,348,180,309,20,39,91,113,53,88,141,30,20,18,50,110,511
2706,Gabe York,SR,2015-16,G,Arizona,Pac-12,34,1133,177,419,79,186,98,233,59,78,19,90,109,76,30,9,71,70,511
2707,Antoine Young,JR,2010-11,G,Creighton,MVC,39,1393,172,434,133,311,39,123,128,171,16,85,101,195,37,2,82,51,511
2708,Darrell Arthur,SO,2007-08,F,Kansas,Big 12,40,989,214,394,212,382,2,12,80,114,92,158,250,33,20,53,75,118,510
2709,Kyle Austin,JR,2009-10,F,UC-Riverside,Big West,29,996,180,401,155,331,25,70,125,200,96,118,214,49,19,9,65,62,510
2710,Courtney Bradley,SR,2006-07,F,Jacksonville State,OVC,30,982,187,405,155,313,32,92,104,134,76,134,210,35,43,7,87,94,510
2711,Jason Carter,SO,2018-19,F,Ohio,MAC,31,962,180,374,157,307,23,67,127,177,65,143,208,61,20,21,55,77,510
2712,Karl Cochran,SR,2014-15,G,Wofford,Southern,35,1091,182,468,84,200,98,268,48,74,29,176,205,94,63,36,57,67,510
2713,Jay Couisnard,SR,2010-11,F,Missouri-Kansas City,Summit,29,971,171,350,126,227,45,123,123,193,53,108,161,47,37,18,92,90,510
2714,A.J. Davis,JR,2011-12,G,James Madison,CAA,32,1038,169,387,116,227,53,160,119,162,38,112,150,61,55,9,85,62,510
2715,Anthony Drmic,JR,2013-14,G,Boise State,MWC,32,1048,171,388,110,209,61,179,107,137,32,112,144,55,36,3,60,87,510
2716,Ian Dubose,SO,2018-19,G,Houston Baptist,Southland,30,911,173,356,120,235,53,121,111,157,45,133,178,103,47,8,80,78,510
2717,Kahlil Dukes,JR,2016-17,G,Niagara,MAAC,33,1113,170,413,105,256,65,157,105,114,8,89,97,136,32,1,82,55,510
2718,Skyler Flatten,SR,2018-19,G,South Dakota State,Summit,33,1205,185,358,101,167,84,191,56,82,9,116,125,73,41,13,44,53,510
2719,Olivier Hanlan,FR,2012-13,G,Boston College,ACC,33,1129,167,364,117,237,50,127,126,168,26,111,137,75,38,2,73,66,510
2722,Robert Hines,JR,2006-07,F,St. Francis (NY),NEC,31,1090,175,458,147,352,28,106,132,173,72,111,183,75,30,19,119,82,510
2723,Denzel Ingram,SR,2016-17,G,North Carolina-Wilmington,CAA,35,1171,173,435,64,139,109,296,55,78,19,57,76,189,47,3,60,66,510
2724,Matt Klinewski,SR,2017-18,F,Lafayette,Patriot,31,831,177,351,126,232,51,119,105,129,35,144,179,46,14,22,61,74,510
2725,Jeremiah Martin,JR,2017-18,G,Memphis,AAC,27,936,157,354,106,198,51,156,145,185,20,95,115,103,61,17,73,52,510
2726,Matt Morgan,FR,2015-16,G,Cornell,Ivy,27,829,159,384,89,170,70,214,122,151,11,74,85,53,38,10,52,46,510
2727,Travis Munnings,JR,2017-18,F,Louisiana-Monroe,Sun Belt,32,1106,185,394,115,213,70,181,70,97,53,180,233,76,40,6,53,80,510
2728,Eli Pemberton,JR,2018-19,G,Hofstra,CAA,34,1203,153,341,110,218,43,123,161,210,45,119,164,78,29,3,59,77,510
2729,Tim Pollitz,SR,2007-08,F,Miami (OH),MAC,33,1171,215,402,209,384,6,18,74,111,78,156,234,101,39,18,91,84,510
2730,Javon Randolph,JR,2005-06,G,Savannah State,Ind,30,994,170,397,112,244,58,153,112,142,36,68,104,41,36,6,85,61,510
2731,J.R. Reynolds,JR,2005-06,G,Virginia,ACC,30,997,161,396,101,226,60,170,128,165,19,75,94,92,24,3,84,72,510
2732,John Roberson,JR,2009-10,G,Texas Tech,Big 12,35,1258,148,348,77,176,71,172,143,179,16,63,79,190,40,1,100,92,510
2733,Richard Roby,SO,2005-06,G,Colorado,Big 12,30,905,172,408,109,231,63,177,103,140,46,118,164,74,62,27,64,52,510
2734,Lodrick Stewart,SR,2006-07,G,Southern California,Pac-10,37,1152,186,406,109,231,77,175,61,84,15,114,129,45,39,14,61,70,510
2735,Joah Tucker,SR,2005-06,F,Milwaukee,Horizon,31,948,179,389,145,272,34,117,118,181,64,120,184,53,19,8,93,85,510
2736,Maalik Wayns,JR,2011-12,G,Villanova,Big East,29,975,162,391,117,240,45,151,141,158,15,95,110,133,28,1,87,78,510
2737,Chaz Williams,JR,2012-13,G,Massachusetts,A-10,33,1165,166,383,123,254,43,129,135,172,25,112,137,242,66,5,114,96,510
2738,Elijah Wilson,SR,2016-17,G,Coastal Carolina,Sun Belt,39,1182,174,493,74,188,100,305,62,83,36,89,125,49,38,2,71,75,510
2739,Kris Yanku,SO,2014-15,G,Northern Arizona,Big Sky,37,1111,130,393,110,325,20,68,230,289,22,143,165,189,43,1,115,94,510
2740,Deng Adel,JR,2017-18,F,Louisville,ACC,34,1126,178,397,128,254,50,143,103,131,22,154,176,94,21,11,77,49,509
2741,Blake Ahearn,SR,2006-07,G,Missouri State,MVC,33,1023,152,326,58,124,94,202,111,120,7,66,73,70,21,1,65,48,509
2744,Jeff Ayres,SR,2008-09,F,Arizona State,Pac-10,35,1139,198,300,198,299,0,1,113,145,87,200,287,31,17,30,43,94,509
2745,Jared Brownridge,SO,2014-15,G,Santa Clara,WCC,32,1079,161,365,68,150,93,215,94,109,12,80,92,81,34,4,47,58,509
2746,Jon Davis,JR,2017-18,G,Charlotte,CUSA,29,1051,159,406,111,260,48,146,143,181,25,85,110,160,27,9,114,44,509
2747,Eric Eaves,SR,2016-17,G,South Carolina State,MEAC,31,921,175,377,140,268,35,109,124,180,40,84,124,78,20,11,60,51,509
2748,Alex Francis,SO,2011-12,F,Bryant,NEC,30,979,185,361,172,323,13,38,126,189,63,159,222,46,22,5,143,65,509
2749,Anthony Gill,SR,2015-16,F,Virginia,ACC,37,1037,189,326,187,324,2,2,129,173,80,147,227,28,24,21,42,85,509
2750,AJ Green,FR,2018-19,G,Northern Iowa,MVC,34,1017,184,449,113,245,71,204,70,81,13,90,103,77,21,2,94,69,509
2751,Tyree Griffin,JR,2017-18,G,Southern Mississippi,CUSA,34,1207,181,420,126,266,55,154,92,132,25,113,138,201,59,3,89,58,509
2752,Cezar Guerrero,SO,2013-14,G,Fresno State,MWC,39,1140,163,396,92,190,71,206,112,128,16,113,129,137,52,3,82,95,509
2753,Maurice Hampton,SR,2005-06,G,Austin Peay,OVC,31,1025,153,370,96,195,57,175,146,170,13,74,87,84,55,4,58,72,509
2754,Tucker Haymond,JR,2015-16,G,Western Michigan,MAC,32,1019,169,398,137,275,32,123,139,196,61,125,186,73,21,1,74,70,509
2755,Justin Jackson,SO,2015-16,F,North Carolina,ACC,40,1135,202,428,165,304,37,124,68,102,71,85,156,111,25,17,43,69,509
2756,Anthony Johnson,JR,2008-09,G,Montana,Big Sky,29,907,164,326,145,271,19,55,162,186,14,66,80,90,20,5,85,54,509
2757,B.J. Johnson,JR,2016-17,G,La Salle,A-10,29,945,168,374,104,197,64,177,109,130,39,144,183,28,33,14,68,71,509
2758,Adreian Payne,SR,2013-14,C,Michigan State,Big Ten,31,870,178,354,134,250,44,104,109,138,48,177,225,41,15,28,63,80,509
2759,MaCio Teague,FR,2016-17,G,North Carolina-Asheville,Big South,33,1124,169,361,99,207,70,154,101,114,18,133,151,90,36,7,31,46,509
2760,Kendall Timmons,SO,2010-11,G,Tulane,CUSA,30,1082,176,396,154,340,22,56,135,210,62,187,249,98,58,17,87,80,509
2761,Ed Tyson,SO,2006-07,G,Maryland-Eastern Shore,MEAC,31,1119,172,460,115,280,57,180,108,154,48,84,132,52,32,1,86,76,509
2762,Harold Washington,JR,2011-12,G,Canisius,MAAC,30,1049,182,411,155,336,27,75,118,152,39,89,128,83,31,1,94,50,509
2763,Sonny Weems,SR,2007-08,F,Arkansas,SEC,34,1067,197,425,143,279,54,146,61,76,56,96,152,89,45,8,96,74,509
2766,Delon Wright,SR,2014-15,G,Utah,Pac-12,35,1165,165,324,139,251,26,73,153,183,34,139,173,178,73,34,68,49,509
2767,Josh Young,JR,2008-09,G,Drake,MVC,33,1105,141,370,82,186,59,184,168,198,37,88,125,45,34,1,69,51,509
2768,Brian Beard Jr.,JR,2017-18,G,Florida International,CUSA,31,1114,167,411,131,265,36,146,138,213,6,114,120,178,90,0,100,77,508
2769,Ryan Broekhoff,JR,2011-12,G,Valparaiso,Horizon,34,1107,161,328,95,159,66,169,120,151,62,228,290,79,45,21,57,67,508
2770,Bobby Brown,JR,2005-06,G,Cal State Fullerton,Big West,29,1013,182,427,110,236,72,191,72,99,13,63,76,132,45,6,96,60,508
2771,Earl Brown,SR,2014-15,F,Saint Francis (PA),NEC,32,1133,188,349,171,297,17,52,115,169,74,181,255,61,34,31,106,59,508
2772,Marcus Burton,SR,2014-15,G,Wagner,NEC,29,979,174,434,113,244,61,190,99,122,15,62,77,46,33,0,66,57,508
2773,Schadrac Casimir,FR,2014-15,G,Iona,MAAC,35,1201,156,365,62,143,94,222,102,114,19,79,98,69,39,2,41,77,508
2774,Jake Cohen,SR,2012-13,F,Davidson,Southern,34,871,171,344,133,246,38,98,128,154,48,133,181,51,23,56,59,111,508
2775,Brandon Cotton,JR,2005-06,G,Detroit Mercy,Horizon,29,1025,183,440,138,320,45,120,97,127,10,47,57,72,21,3,61,40,508
2776,Tony Danridge,SR,2008-09,G,New Mexico,MWC,34,1091,176,364,170,336,6,28,150,201,36,103,139,91,41,4,73,75,508
2777,Kellen Dunham,SO,2013-14,G,Butler,Big East,31,1119,164,420,86,200,78,220,102,127,13,110,123,52,21,8,66,46,508
2778,Scott Eatherton,JR,2013-14,F,Northeastern,CAA,32,994,180,333,165,299,15,34,133,200,103,224,327,37,17,57,86,97,508
2779,Tim Frazier,SR,2013-14,G,Penn State,Big Ten,34,1196,163,379,138,293,25,86,157,200,31,120,151,182,53,6,92,87,508
2780,Elias Harris,FR,2009-10,F,Gonzaga,WCC,34,998,180,329,157,278,23,51,125,185,70,171,241,38,32,16,64,88,508
2781,LaVone Holland,JR,2016-17,G,Northern Kentucky,Horizon,35,1081,172,390,116,237,56,153,108,164,18,80,98,143,45,9,106,65,508
2782,David Hoskins,JR,2006-07,G,Kansas State,Big 12,35,967,162,359,149,296,13,63,171,231,86,120,206,88,35,9,90,84,508
2783,Matt Janning,SR,2009-10,G,Northeastern,CAA,33,1190,175,425,123,267,52,158,106,141,17,113,130,102,51,6,70,55,508
2784,Moses Kingsley,SO,2015-16,C,Arkansas,SEC,32,945,183,334,183,334,0,0,142,223,103,196,299,39,36,76,65,94,508
2785,Jaron Martin,SR,2016-17,G,UC-Irvine,Big West,36,1082,185,422,105,227,80,195,58,69,14,89,103,113,29,1,62,49,508
2788,Anthony Miles,SR,2011-12,G,Lamar,Southland,35,1118,149,342,120,263,29,79,181,222,34,128,162,142,58,1,81,74,508
2789,Carlos Monroe,JR,2007-08,F,Florida Atlantic,Sun Belt,33,926,188,362,184,354,4,8,128,233,58,254,312,33,37,8,76,90,508
2790,Lee Moore,JR,2015-16,G,Texas-El Paso,CUSA,33,1053,156,345,107,212,49,133,147,198,50,128,178,116,46,10,70,70,508
2791,Tyler Murray,JR,2010-11,G,Wagner,NEC,30,1113,157,358,98,216,59,142,135,163,25,113,138,107,38,8,96,51,508
2792,Jose Olivero,SR,2006-07,G,Lehigh,Patriot,31,1009,154,400,108,240,46,160,154,204,25,80,105,71,37,0,90,89,508
2793,Gyno Pomare,JR,2007-08,C,San Diego,WCC,36,1033,188,338,188,337,0,1,132,184,102,163,265,27,29,48,52,88,508
2794,Trevor Releford,JR,2012-13,G,Alabama,SEC,34,1130,167,351,119,233,48,118,126,153,21,71,92,85,70,2,62,69,508
2795,Junior Robinson,JR,2016-17,G,Mount St. Mary's,NEC,36,1201,160,378,90,202,70,176,118,136,8,50,58,103,32,4,93,75,508
2796,T.J. Robinson,SO,2009-10,F,Long Beach State,Big West,33,1054,193,371,193,371,0,0,122,216,117,215,332,27,19,4,79,67,508
2797,Montrael Scott,JR,2013-14,G,Prairie View,SWAC,34,1060,174,389,100,212,74,177,86,114,49,105,154,65,45,1,77,72,508
2798,Jeff Short,SR,2015-16,G,Norfolk State,MEAC,33,955,154,375,87,189,67,186,133,162,14,105,119,86,28,4,74,87,508
2799,TaShawn Thomas,JR,2013-14,F,Houston,AAC,33,1044,205,347,204,341,1,6,97,163,93,173,266,63,41,90,74,66,508
2800,Giordan Watson,SR,2007-08,G,Central Michigan,MAC,31,1028,168,403,104,237,64,166,108,144,17,57,74,138,58,7,84,74,508
2801,Mike Williams,SR,2010-11,G,Western Carolina,Southern,33,1041,190,480,135,319,55,161,73,92,32,83,115,127,67,6,93,103,508
2802,Kyle Wilson,JR,2014-15,G,Army,Patriot,29,939,171,445,97,226,74,219,92,117,14,69,83,54,23,3,77,51,508
2803,Jeff Withey,SR,2012-13,C,Kansas,Big 12,37,1144,185,318,184,317,1,1,137,192,79,236,315,35,28,146,73,77,508
2804,Emile Blackman,JR,2015-16,G,Niagara,MAAC,32,1067,185,426,143,282,42,144,95,118,38,74,112,44,29,6,84,88,507
2805,Desonta Bradford,SR,2017-18,G,East Tennessee State,Southern,33,1075,180,380,138,245,42,135,105,142,26,165,191,116,62,15,72,64,507
2806,Jeffrey Carroll,SR,2017-18,G,Oklahoma State,Big 12,33,1012,167,411,100,209,67,202,106,137,52,152,204,59,27,9,64,56,507
2807,Brandon Clark,SR,2014-15,G,Santa Clara,WCC,32,1045,163,434,113,257,50,177,131,153,12,106,118,124,28,0,68,84,507
2808,Caleb Daniels,SO,2018-19,G,Tulane,AAC,30,1018,174,391,127,255,47,136,112,163,42,118,160,99,23,9,86,86,507
2809,James Demery,SR,2017-18,F,Saint Joseph's,A-10,30,1024,195,409,173,330,22,79,95,149,49,116,165,33,35,9,45,48,507
2810,Tim Derksen,SR,2015-16,G,San Francisco,WCC,30,978,177,358,127,245,50,113,103,141,74,134,208,60,21,9,47,79,507
2811,Bam Doyne,SR,2006-07,G,Mississippi,SEC,34,1043,166,408,124,279,42,129,133,173,32,115,147,65,37,9,78,88,507
2812,Kim English,SR,2011-12,G,Missouri,Big 12,35,1175,171,328,93,158,78,170,87,120,30,118,148,56,45,10,59,83,507
2813,Shannon Evans,SO,2014-15,G,Buffalo,MAC,33,1139,163,395,97,222,66,173,115,144,15,89,104,153,56,10,84,69,507
2814,Marcus Gilbert,JR,2014-15,F,Fairfield,MAAC,31,1075,154,348,98,177,56,171,143,184,49,124,173,38,25,19,67,70,507
2815,Isaac Hamilton,SR,2016-17,G,UCLA,Pac-12,36,1080,193,426,119,224,74,202,47,57,30,98,128,99,25,6,71,63,507
2816,Sam Hauser,JR,2018-19,F,Marquette,Big East,34,1134,173,377,85,158,88,219,73,79,35,209,244,82,22,18,46,70,507
2817,Desmond Haymon,SR,2013-14,G,Stephen F. Austin,Southland,35,1060,155,369,94,202,61,167,136,204,42,90,132,100,29,2,58,70,507
2818,Josh Heytvelt,SR,2008-09,F,Gonzaga,WCC,34,993,186,342,163,285,23,57,112,156,63,159,222,22,20,30,43,85,507
2819,Cameron Jackson,SR,2018-19,F,Wofford,Southern,35,815,199,347,191,327,8,20,101,164,92,174,266,97,52,35,74,99,507
2820,Justin Johnson,SO,2015-16,F,Western Kentucky,CUSA,34,984,197,327,196,318,1,9,112,166,102,168,270,48,16,19,58,73,507
2821,Melvin Johnson,SO,2010-11,G,Texas-San Antonio,Southland,34,914,171,410,91,194,80,216,85,99,17,101,118,21,30,5,57,59,507
2822,Tommie Liddell,SO,2006-07,G,Saint Louis,A-10,33,1182,183,386,134,278,49,108,92,120,52,173,225,87,27,19,99,63,507
2823,Ervin Mitchell,SR,2016-17,G,Grambling,SWAC,30,963,166,352,124,246,42,106,133,190,26,83,109,30,39,12,66,85,507
2824,Mike Muscala,SO,2010-11,F,Bucknell,Patriot,34,944,187,362,183,351,4,11,129,158,57,191,248,47,14,67,58,90,507
2825,Javion Ogunyemi,JR,2015-16,F,Siena,MAAC,34,1065,182,335,175,312,7,23,136,201,113,95,208,33,14,71,66,105,507
2826,Pookie Powell,JR,2017-18,G,La Salle,A-10,30,1105,178,442,122,265,56,177,95,118,11,114,125,130,25,4,79,55,507
2827,Frank Robinson,SR,2007-08,G,Cal State Fullerton,Big West,32,983,175,388,122,233,53,155,104,141,68,152,220,80,39,16,74,87,507
2830,Brandon Rush,JR,2007-08,G,Kansas,Big 12,38,1127,180,414,100,223,80,191,67,86,57,138,195,81,32,32,69,60,507
2831,Marcus Smart,FR,2012-13,G,Oklahoma State,Big 12,33,1106,151,374,113,243,38,131,167,215,50,142,192,139,99,22,111,92,507
2832,Greg Sprink,JR,2006-07,G,Navy,Patriot,30,1026,157,346,91,172,66,174,127,147,31,112,143,73,27,0,74,88,507
2833,James Thompson IV,JR,2017-18,F,Eastern Michigan,MAC,35,1195,201,299,201,299,0,0,105,173,144,249,393,11,27,67,66,115,507
2834,Deon Thompson,SR,2009-10,F,North Carolina,ACC,37,994,196,405,196,403,0,2,115,166,106,141,247,31,40,36,65,80,507
2835,Brian Warren,JR,2018-19,G,Texas-Arlington,Sun Belt,33,986,176,443,124,272,52,171,103,128,15,71,86,119,39,3,71,98,507
2836,Isaac Wells,SR,2006-07,F,Arkansas State,Sun Belt,32,1076,190,435,157,333,33,102,94,134,56,208,264,74,31,33,110,71,507
2837,Brendan Winters,SR,2005-06,G,Davidson,Southern,30,957,175,408,118,240,57,168,100,119,45,98,143,53,20,7,53,66,507
2838,Chris Wright,JR,2009-10,F,Dayton,A-10,37,1058,187,373,179,335,8,38,125,185,92,177,269,44,37,53,87,84,507
2839,Raheem Appleby,SO,2012-13,G,Louisiana Tech,WAC,34,895,196,484,144,311,52,173,62,87,27,64,91,42,37,7,59,32,506
2840,Ike Azotam,SO,2011-12,F,Quinnipiac,NEC,32,982,202,363,202,363,0,0,102,167,116,188,304,26,26,32,51,101,506
2841,Jon Brockman,SR,2008-09,F,Washington,Pac-10,34,1036,190,361,190,360,0,1,126,197,144,247,391,39,31,3,65,102,506
2842,Julius Brown,JR,2013-14,G,Toledo,MAC,34,1145,163,390,104,224,59,166,121,139,10,64,74,205,39,4,94,46,506
2843,Eric Carter,SR,2018-19,F,Delaware,CAA,32,1025,190,328,188,323,2,5,124,168,72,239,311,75,21,20,73,90,506
2844,Tyler Cook,SO,2017-18,F,Iowa,Big Ten,33,923,192,339,191,332,1,7,121,183,72,152,224,58,21,20,82,87,506
2845,Tyron Criswell,SR,2015-16,G,Nevada,MWC,38,1150,173,340,160,294,13,46,147,205,93,142,235,79,39,23,79,110,506
2846,Matt Farrell,JR,2016-17,G,Notre Dame,ACC,36,1238,172,384,91,191,81,193,81,102,9,63,72,196,51,5,91,71,506
2847,Paul Harris,SO,2007-08,F,Syracuse,Big East,35,1264,161,343,150,309,11,34,173,237,99,187,286,117,59,28,117,90,506
2848,Taveion Hollingsworth,FR,2017-18,G,Western Kentucky,CUSA,38,1312,170,354,125,235,45,119,121,153,31,98,129,71,39,5,67,75,506
2849,Justin Hurtt,JR,2009-10,G,Tulsa,CUSA,35,1175,169,403,91,203,78,200,90,111,20,99,119,58,22,8,66,60,506
2852,Dominic James,SO,2006-07,G,Marquette,Big East,34,1130,171,445,121,261,50,184,114,175,20,84,104,167,64,5,89,72,506
2853,Damian Jones,SO,2014-15,C,Vanderbilt,SEC,35,1020,186,331,185,326,1,5,133,222,76,151,227,26,20,70,76,89,506
2854,Tyrone Kent,JR,2007-08,G,Toledo,MAC,30,1064,158,435,92,223,66,212,124,160,30,85,115,91,53,16,140,75,506
2855,Alex McLean,SR,2007-08,F,Liberty,Big South,32,1047,197,352,195,342,2,10,110,156,90,192,282,31,13,14,62,75,506
2856,Jared Mintz,SR,2010-11,F,Lafayette,Patriot,32,971,168,331,165,318,3,13,167,205,67,119,186,69,20,7,62,83,506
2857,Matt Morgan,SO,2016-17,G,Cornell,Ivy,28,906,165,362,79,133,86,229,90,105,13,116,129,60,22,6,71,60,506
2858,Dominique Morrison,SO,2009-10,F,Oral Roberts,Summit,33,1161,164,395,121,275,43,120,135,162,35,133,168,85,29,13,60,88,506
2859,Steffphon Pettigrew,JR,2009-10,F,Western Kentucky,Sun Belt,34,1119,196,400,159,287,37,113,77,125,81,118,199,40,28,15,58,85,506
2860,Courtney Pigram,JR,2007-08,G,East Tennessee State,A-Sun,32,1060,186,462,125,278,61,184,73,97,19,82,101,109,45,4,97,74,506
2861,Dwight Powell,JR,2012-13,F,Stanford,Pac-12,34,1032,179,383,164,350,15,33,133,167,72,213,285,72,26,39,83,104,506
2862,Samardo Samuels,SO,2009-10,F,Louisville,Big East,33,968,176,336,176,336,0,0,154,218,106,125,231,39,20,37,82,87,506
2863,Jaleen Smith,SR,2016-17,G,New Hampshire,AEC,32,1158,179,384,131,250,48,134,100,128,42,163,205,137,29,20,95,85,506
2864,Domonic Tilford,SR,2008-09,G,South Alabama,Sun Belt,31,1077,168,411,85,205,83,206,87,104,11,74,85,92,29,1,80,36,506
2865,Josh Williams,SR,2018-19,G,Robert Morris,NEC,35,1131,162,414,59,142,103,272,79,103,19,81,100,83,35,5,82,69,506
2866,Trey Zeigler,FR,2010-11,G,Central Michigan,MAC,31,1067,191,484,165,405,26,79,98,173,41,126,167,67,42,29,102,83,506
2867,Mohamed Abukar,SR,2006-07,F,San Diego State,MWC,32,1061,185,392,166,329,19,63,116,140,44,141,185,51,15,19,69,83,505
2868,Jordan Adams,FR,2012-13,G,UCLA,Pac-12,33,999,165,369,119,219,46,150,129,153,21,106,127,58,73,12,40,69,505
2869,KeVaughn Allen,SO,2016-17,G,Florida,SEC,36,1029,168,384,90,173,78,211,91,103,8,78,86,53,45,10,46,56,505
2870,Ryan Anderson,SR,2015-16,F,Arizona,Pac-12,33,963,174,319,172,312,2,7,155,208,99,235,334,26,23,20,63,70,505
2871,Devon Andrews,JR,2018-19,F,Florida International,CUSA,33,866,179,363,143,262,36,101,111,156,40,127,167,46,56,15,60,82,505
2874,George Beamon,SO,2010-11,G,Manhattan,MAAC,31,1141,180,412,174,372,6,40,139,188,73,116,189,41,45,15,64,90,505
2875,Zack Bryant,SO,2018-19,G,Alabama-Birmingham,CUSA,34,1136,181,416,132,263,49,153,94,138,17,102,119,134,62,13,77,78,505
2876,Deonte Burton,JR,2012-13,G,Nevada,MWC,31,1057,159,354,125,241,34,113,153,213,18,56,74,112,42,14,73,61,505
2877,Omar Carter,JR,2010-11,G,Appalachian State,Southern,31,1042,184,395,146,300,38,95,99,131,51,129,180,40,26,7,52,57,505
2878,Will Cherry,JR,2011-12,G,Montana,Big Sky,32,1082,161,362,110,225,51,137,132,169,20,104,124,105,83,11,90,80,505
2879,Darell Combs,JR,2015-16,G,IUPUI,Summit,31,950,165,386,107,247,58,139,117,155,12,58,70,68,31,1,101,93,505
2880,Chris Daniels,SR,2006-07,C,Texas A&M-Corpus Christi,Southland,33,849,194,329,186,304,8,25,109,158,60,160,220,25,24,53,72,98,505
2881,Boo Davis,SR,2005-06,G,Milwaukee,Horizon,31,845,159,385,68,151,91,234,96,125,44,113,157,38,46,5,52,58,505
2882,Justin Dentmon,SR,2008-09,G,Washington,Pac-10,35,992,160,353,97,200,63,153,122,148,30,66,96,86,53,5,66,65,505
2883,Spencer Dinwiddie,SO,2012-13,G,Colorado,Pac-12,33,1073,130,313,83,174,47,139,198,240,9,96,105,99,44,16,73,65,505
2884,Jeff Dowtin,JR,2018-19,G,Rhode Island,A-10,33,1207,190,400,144,270,46,130,79,106,22,90,112,122,45,15,59,48,505
2885,Matt Farrell,SR,2017-18,G,Notre Dame,ACC,31,1111,168,410,70,150,98,260,71,87,6,69,75,169,32,2,74,46,505
2886,Bryn Forbes,SR,2015-16,G,Michigan State,Big Ten,35,982,165,343,53,110,112,233,63,75,12,61,73,52,14,1,30,51,505
2887,Jayden Gardner,FR,2018-19,F,East Carolina,AAC,31,949,166,337,164,327,2,10,171,228,93,169,262,39,24,14,75,88,505
2888,Malik Hairston,SR,2007-08,G,Oregon,Pac-10,31,976,176,335,124,215,52,120,101,138,45,105,150,66,19,26,55,90,505
2889,Jeremy Harris,SR,2018-19,G,Buffalo,MAC,36,1124,194,464,132,234,62,230,55,76,48,175,223,108,40,25,56,54,505
2890,Trevon Hughes,SR,2009-10,G,Wisconsin,Big Ten,33,1077,162,399,88,212,74,187,107,150,40,108,148,86,55,16,68,107,505
2891,Luis Jacobo,SR,2013-14,F,Purdue-Fort Wayne,Summit,33,964,171,370,97,184,74,186,89,110,24,135,159,45,25,9,58,57,505
2892,Matt Kingsley,SR,2008-09,C,Stephen F. Austin,Southland,32,961,213,389,213,388,0,1,79,123,62,183,245,29,16,39,58,72,505
2893,Derrick Marks,JR,2013-14,G,Boise State,MWC,34,961,173,392,154,326,19,66,140,173,15,99,114,89,51,10,89,99,505
2896,Devin Martin,SR,2015-16,G,Maryland-Eastern Shore,MEAC,30,987,174,410,107,224,67,186,90,119,31,108,139,63,38,10,72,64,505
2897,Sean McGonagill,SR,2013-14,G,Brown,Ivy,29,1084,162,405,69,172,93,233,88,113,17,108,125,109,38,1,50,72,505
2898,Shonn Miller,SR,2014-15,F,Cornell,Ivy,30,940,168,387,140,283,28,104,141,169,28,226,254,30,38,54,53,86,505
2899,Raymar Morgan,SO,2007-08,F,Michigan State,Big Ten,36,997,187,335,177,302,10,33,121,180,78,143,221,58,33,19,83,99,505
2900,Mark Porter,SR,2007-08,G,Wagner,NEC,31,1160,151,380,111,241,40,139,163,210,18,132,150,172,59,28,126,55,505
2901,Dwight Powell,SR,2013-14,F,Stanford,Pac-12,36,1167,175,379,165,340,10,39,145,211,70,177,247,112,47,30,104,113,505
2902,Maureece Rice,JR,2006-07,G,George Washington,A-10,32,1097,186,414,122,265,64,149,69,95,35,81,116,66,43,3,56,50,505
2903,Jermaine Ruttley,JR,2014-15,G,Florida A&M,MEAC,29,956,181,401,148,289,33,112,110,162,40,154,194,62,46,2,69,88,505
2904,Justin Rutty,JR,2009-10,F,Quinnipiac,NEC,33,1040,205,378,205,378,0,0,95,151,163,196,359,29,34,18,74,96,505
2905,David Schroeder,SR,2006-07,G,Idaho State,Big Sky,30,1092,170,388,91,201,79,187,86,113,22,142,164,44,44,3,59,62,505
2906,D.J. Strawberry,SR,2006-07,G,Maryland,ACC,34,1083,184,386,149,284,35,102,102,149,45,106,151,119,69,14,74,87,505
2907,Stephen Thompson Jr.,JR,2017-18,G,Oregon State,Pac-12,32,1172,187,406,123,222,64,184,67,102,25,75,100,104,55,11,67,72,505
2908,Mitchell Watt,SR,2011-12,F,Buffalo,MAC,31,937,189,341,178,307,11,34,116,156,66,167,233,72,19,67,80,88,505
2909,Wendell White,SR,2006-07,G,Nevada-Las Vegas,MWC,35,958,210,409,209,394,1,15,84,125,89,125,214,40,43,13,56,85,505
2910,Brenton Williams,SR,2013-14,G,South Carolina,SEC,34,1030,146,345,53,127,93,218,120,129,15,49,64,46,37,0,41,44,505
2911,Jarvis Williams,JR,2013-14,F,Murray State,OVC,34,1105,184,284,184,284,0,0,137,208,128,210,338,22,26,60,67,89,505
2912,Trey Zeigler,SO,2011-12,G,Central Michigan,MAC,32,1016,199,431,188,393,11,38,96,194,74,141,215,79,36,22,82,81,505
2913,Zach Auguste,SR,2015-16,F,Notre Dame,ACC,36,1065,192,343,192,343,0,0,120,191,122,264,386,38,23,39,88,86,504
2914,Frank Bartley,JR,2016-17,G,Louisiana,Sun Belt,33,1068,162,367,94,177,68,190,112,156,28,114,142,85,55,3,64,80,504
2915,Kadeem Batts,JR,2012-13,F,Providence,Big East,34,1079,188,393,188,390,0,3,128,185,101,145,246,35,22,23,72,122,504
2916,Korey Billbury,SO,2013-14,G,Oral Roberts,Southland,33,1070,174,378,150,314,24,64,132,182,77,152,229,83,36,6,77,98,504
2917,Markel Brown,JR,2012-13,G,Oklahoma State,Big 12,33,1126,169,388,117,245,52,143,114,150,16,130,146,80,33,26,57,70,504
2918,Trey Burke,FR,2011-12,G,Michigan,Big Ten,34,1227,177,409,120,245,57,164,93,125,22,96,118,156,31,13,94,53,504
2919,Darren Collison,SR,2008-09,G,UCLA,Pac-10,35,1103,175,344,134,240,41,104,113,126,16,68,84,166,57,5,87,53,504
2920,Anthony Cowan,SO,2017-18,G,Maryland,Big Ten,32,1184,144,341,90,194,54,147,162,191,7,133,140,164,48,10,89,65,504
2921,David Dees,JR,2006-07,G,Louisiana,Sun Belt,29,1031,164,406,137,299,27,107,149,192,55,99,154,86,30,10,67,57,504
2922,Mike DiNunno,SR,2012-13,G,Eastern Kentucky,OVC,34,1200,163,386,72,152,91,234,87,102,11,60,71,147,64,0,91,81,504
2923,Torin Dorn,SR,2018-19,G,North Carolina State,ACC,36,1026,209,434,186,358,23,76,63,107,80,180,260,45,36,9,52,50,504
2924,Ben Drayton,JR,2010-11,G,Georgia Southern,Southern,32,1184,185,385,165,309,20,76,114,159,35,79,114,146,60,1,113,74,504
2925,Chris Gaston,FR,2009-10,F,Fordham,A-10,28,981,190,423,188,401,2,22,122,182,115,204,319,43,26,50,126,73,504
2926,Taylor Johns,JR,2014-15,F,UC-Riverside,Big West,31,1067,191,411,182,373,9,38,113,177,80,175,255,59,37,52,106,91,504
2927,Jalen Jones,SR,2015-16,G,Texas A&M,SEC,33,902,175,412,141,307,34,105,120,171,64,172,236,21,22,9,53,94,504
2928,Derrick Marks,SO,2012-13,G,Boise State,MWC,31,934,169,363,147,311,22,52,144,172,20,98,118,122,56,14,106,94,504
2929,Cartier Martin,JR,2005-06,F,Kansas State,Big 12,28,919,161,341,111,224,50,117,132,157,64,122,186,52,27,6,58,68,504
2930,Cody Martin,JR,2017-18,F,Nevada,MWC,36,1284,193,374,178,323,15,51,103,147,65,160,225,169,60,53,73,87,504
2931,Xavier Munford,JR,2012-13,G,Rhode Island,A-10,29,1027,168,426,100,228,68,198,100,140,8,74,82,56,30,10,77,70,504
2932,D.J. Newbill,SO,2012-13,G,Penn State,Big Ten,31,1133,175,432,155,357,20,75,134,196,48,107,155,125,36,8,120,90,504
2933,Carson Puriefoy,JR,2014-15,G,Stony Brook,AEC,35,1158,161,423,110,255,51,168,131,173,16,95,111,118,40,10,98,74,504
2934,K.C. Rivers,SO,2006-07,G,Clemson,ACC,36,1048,183,396,95,173,88,223,50,68,56,106,162,65,44,5,44,77,504
2935,Keston Roberts,SR,2006-07,G,Youngstown State,Horizon,31,1047,193,453,148,314,45,139,73,88,28,76,104,52,25,12,73,62,504
2938,Tyler Sharpe,JR,2018-19,G,Northern Kentucky,Horizon,35,1125,154,363,64,128,90,235,106,136,17,88,105,64,52,3,42,84,504
2939,Jason Smith,JR,2006-07,F,Colorado State,MWC,30,905,175,302,175,299,0,3,154,200,98,206,304,58,16,47,102,94,504
2940,Kyle Spain,SR,2008-09,F,San Diego State,MWC,36,978,150,373,83,202,67,171,137,164,61,128,189,52,45,11,74,73,504
2941,Christian Standhardinger,JR,2012-13,F,Hawaii,Big West,32,963,184,361,169,316,15,45,121,188,89,163,252,43,45,15,60,69,504
2942,B.J. Taylor,SO,2016-17,G,Central Florida,AAC,29,1056,165,399,117,258,48,141,126,175,11,105,116,101,32,1,64,60,504
2943,Steve Taylor,SR,2016-17,F,Toledo,MAC,33,1058,210,400,200,350,10,50,74,151,78,326,404,123,10,16,117,70,504
2944,Tremont Waters,SO,2018-19,G,Louisiana State,SEC,33,1070,172,400,116,229,56,171,104,128,10,82,92,192,96,4,114,64,504
2945,Tim Williams,JR,2009-10,G,South Alabama,Sun Belt,32,1077,188,438,143,300,45,138,83,127,65,169,234,68,34,8,83,71,504
2946,Theron Wilson,SR,2008-09,F,Bradley,MVC,36,1094,153,331,138,273,15,58,183,251,79,184,263,61,66,19,95,95,504
2947,Alex Zampier,SR,2009-10,G,Yale,Ivy,29,897,161,412,106,228,55,184,127,148,6,78,84,69,59,6,89,50,504
2948,Chris Alexander,SR,2005-06,G,Southern,SWAC,32,1042,185,444,138,285,47,159,86,107,30,76,106,46,42,3,83,52,503
2949,Darian Anderson,SO,2015-16,G,Fairleigh Dickinson,NEC,33,1090,183,446,136,306,47,140,90,113,25,95,120,123,60,9,104,85,503
2950,D.J. Augustin,FR,2006-07,G,Texas,Big 12,35,1245,154,343,109,241,45,102,150,179,21,78,99,233,53,3,115,81,503
2951,Patrick Christopher,SO,2007-08,G,University of California,Pac-10,33,1162,188,412,143,277,45,135,82,103,37,82,119,65,18,3,65,74,503
2952,Angel Delgado,JR,2016-17,F,Seton Hall,Big East,33,1090,197,363,197,363,0,0,109,196,166,265,431,73,21,11,99,83,503
2953,Rudy Gay,SO,2005-06,F,Connecticut,Big East,33,1015,187,406,159,318,28,88,101,138,66,144,210,68,58,52,82,75,503
2954,Matt Kingsley,JR,2007-08,C,Stephen F. Austin,Southland,32,875,171,317,171,316,0,1,161,215,65,118,183,19,18,31,55,89,503
2955,Cameron Krutwig,SO,2018-19,C,Loyola (IL),MVC,34,958,212,337,211,334,1,3,78,135,56,188,244,83,19,34,72,67,503
2956,Maurice Latham,SR,2005-06,F,Campbell,A-Sun,28,908,181,339,163,287,18,52,123,159,112,138,250,61,29,3,80,80,503
2957,Rob Marberry,SR,2018-19,F,Lipscomb,A-Sun,34,817,216,343,216,342,0,1,71,106,50,88,138,65,17,21,29,67,503
2960,Nic Moore,SO,2013-14,G,Southern Methodist,AAC,37,1190,159,343,87,178,72,165,113,137,10,74,84,181,54,2,87,98,503
2961,Anthony Myles,SR,2013-14,G,Rider,MAAC,31,1024,146,350,86,191,60,159,151,199,27,106,133,69,22,10,68,74,503
2962,Luke Nevill,JR,2007-08,C,Utah,MWC,33,952,191,357,191,357,0,0,121,168,72,150,222,43,17,53,73,83,503
2963,Robby Ptacek,SR,2011-12,G,Central Connecticut State,NEC,29,1072,168,408,127,282,41,126,126,137,23,91,114,64,26,2,82,65,503
2964,Colt Ryan,SO,2010-11,G,Evansville,MVC,32,1039,153,368,88,208,65,160,132,151,16,89,105,75,40,7,74,82,503
2965,Larry Sanders,JR,2009-10,F,Virginia Commonwealth,CAA,35,941,196,367,192,351,4,16,107,167,106,213,319,34,26,90,58,103,503
2966,Shavon Shields,SR,2015-16,G,Nebraska,Big Ten,30,921,181,385,153,308,28,77,113,147,39,114,153,80,38,10,72,55,503
2967,Jason Smith,SO,2005-06,F,Colorado State,MWC,31,889,178,344,173,333,5,11,142,186,70,157,227,70,20,66,112,102,503
2968,Chris Thomas,SR,2015-16,G,Texas Southern,SWAC,33,1123,191,378,176,322,15,56,106,200,57,112,169,143,33,12,121,102,503
2969,Ben Uzoh,JR,2008-09,G,Tulsa,CUSA,36,1287,169,386,129,264,40,122,125,158,29,146,175,128,54,18,93,74,503
2970,Marcel White,JR,2015-16,G,Jacksonville,A-Sun,32,1022,160,380,78,172,82,208,101,139,36,143,179,45,25,20,52,67,503
2971,Anthlon Bell,SR,2015-16,G,Arkansas,SEC,32,917,172,402,83,200,89,202,69,82,22,71,93,39,20,7,35,70,502
2972,Vander Blue,JR,2012-13,G,Marquette,Big East,34,1123,183,403,143,271,40,132,96,127,20,90,110,62,36,0,79,60,502
2973,J'Nathan Bullock,JR,2007-08,F,Cleveland State,Horizon,34,1026,165,364,140,287,25,77,147,190,73,153,226,38,29,5,82,81,502
2974,Ahmad Clark,JR,2018-19,G,Albany (NY),AEC,32,984,157,423,99,238,58,185,130,166,15,121,136,137,63,12,114,94,502
2975,Drew Crawford,SR,2013-14,G,Northwestern,Big Ten,32,1170,169,417,119,264,50,153,114,146,40,165,205,71,18,25,69,75,502
2976,Raasean Davis,SR,2018-19,C,North Carolina Central,MEAC,34,1009,213,330,213,330,0,0,76,108,116,194,310,17,29,42,71,96,502
2977,Jourdan Demunyck,SR,2012-13,G,Prairie View,SWAC,32,970,185,468,149,356,36,112,96,136,65,144,209,47,47,6,85,73,502
2978,Ross DeRogatis,SR,2006-07,G,San Diego,WCC,32,1059,158,359,60,109,98,250,88,111,14,69,83,94,33,2,88,76,502
2979,Sundiata Gaines,SR,2007-08,G,Georgia,SEC,34,1144,175,423,132,280,43,143,109,180,72,132,204,143,61,3,89,83,502
2982,Donte Gennie,SR,2006-07,G,Georgia Southern,Southern,31,1052,181,403,99,212,82,191,58,83,20,67,87,81,40,0,70,54,502
2983,Jacob Gilyard,SO,2018-19,G,Richmond,A-10,31,1155,177,375,103,171,74,204,74,96,20,70,90,160,88,1,74,52,502
2984,Jon Goode,SR,2007-08,G,Detroit Mercy,Horizon,26,895,171,378,92,201,79,177,81,103,16,60,76,70,24,0,75,57,502
2985,Kason Harrell,SR,2018-19,G,Purdue-Fort Wayne,Summit,33,998,196,389,138,243,58,146,52,77,25,89,114,60,36,27,51,68,502
2986,Al Horford,JR,2006-07,F,Florida,SEC,38,1057,186,306,186,304,0,2,130,202,96,264,360,82,28,70,68,94,502
2987,Michael Jenkins,JR,2006-07,G,Winthrop,Big South,34,1026,181,394,81,153,100,241,40,57,26,102,128,110,44,12,71,66,502
2988,Ty Jerome,JR,2018-19,G,Virginia,ACC,37,1256,178,409,99,211,79,198,67,91,17,140,157,202,57,1,61,64,502
2989,Daishon Knight,SR,2014-15,G,Illinois State,MVC,35,1046,178,406,133,283,45,123,101,117,26,89,115,85,36,1,63,41,502
2990,Warren Niles,SO,2010-11,G,Oral Roberts,Summit,35,1087,167,428,91,221,76,207,92,113,24,104,128,63,36,5,68,84,502
2991,Darryl Partin,JR,2010-11,G,Boston University,AEC,35,1118,170,420,106,241,64,179,98,129,29,89,118,49,35,9,100,89,502
2992,Nijal Pearson,SO,2017-18,G,Texas State,Sun Belt,33,1077,172,437,114,261,58,176,100,141,67,130,197,80,44,13,80,75,502
2993,Rian Pearson,JR,2012-13,G,Toledo,MAC,28,931,172,380,166,352,6,28,152,207,58,131,189,48,48,3,79,60,502
2994,T.J. Price,SO,2012-13,G,Western Kentucky,Sun Belt,33,1089,170,430,89,204,81,226,81,116,30,117,147,79,38,13,87,78,502
2995,James Scott,SO,2017-18,G,Kennesaw State,A-Sun,29,923,188,452,134,293,54,159,72,90,16,53,69,65,50,6,77,66,502
2996,Ronshad Shabazz,SO,2016-17,G,Appalachian State,Sun Belt,30,929,176,442,110,241,66,201,84,116,16,90,106,51,23,2,52,57,502
2997,Kendall Smith,JR,2016-17,G,Cal State Northridge,Big West,30,1003,171,382,126,262,45,120,115,151,22,98,120,143,40,8,82,62,502
2998,Travis Smith,SR,2012-13,G,Mercer,A-Sun,36,1081,157,347,83,176,74,171,114,127,16,84,100,68,28,2,73,78,502
2999,Deshon Taylor,SR,2018-19,G,Fresno State,MWC,28,996,152,341,85,174,67,167,131,167,18,85,103,139,40,6,81,76,502
3000,Joe Trapani,SR,2010-11,F,Boston College,ACC,34,1017,173,407,123,267,50,140,106,150,61,176,237,61,23,27,64,86,502
3001,Tai Wesley,SR,2010-11,F,Utah State,WAC,34,993,176,294,171,286,5,8,145,204,96,175,271,73,27,36,76,108,502
3004,DaShaun Wood,JR,2005-06,G,Wright State,Horizon,28,988,165,384,143,303,22,81,150,188,34,92,126,131,51,5,97,56,502
3005,Blake Ahearn,JR,2005-06,G,Missouri State,MVC,31,1001,155,364,81,168,74,196,117,125,14,57,71,76,32,1,73,35,501
3006,John Carroll,JR,2017-18,F,Hartford,AEC,33,1038,174,371,154,305,20,66,133,186,56,156,212,80,18,30,67,89,501
3007,Wendell Carter Jr.,FR,2017-18,F,Duke,ACC,37,997,179,319,160,273,19,46,124,168,109,226,335,74,30,76,75,105,501
3008,Stacy Davis,JR,2014-15,F,Pepperdine,WCC,32,1025,165,349,150,297,15,52,156,193,75,173,248,59,30,35,87,74,501
3009,Terence Davis,SR,2018-19,G,Mississippi,SEC,33,1024,179,403,114,228,65,175,78,101,37,154,191,114,54,21,91,88,501
3010,Tavrion Dawson,SR,2017-18,F,Cal State Northridge,Big West,30,990,195,441,168,336,27,105,84,118,45,152,197,60,27,22,70,64,501
3011,Tre Demps,SR,2015-16,G,Northwestern,Big Ten,32,1185,189,475,117,258,72,217,51,77,16,98,114,104,21,1,39,28,501
3012,PJ Dozier,SO,2016-17,G,South Carolina,SEC,36,1033,191,469,149,328,42,141,77,129,39,134,173,101,60,10,78,100,501
3013,Byron Eaton,SR,2008-09,G,Oklahoma State,Big 12,35,1110,135,321,112,244,23,77,208,269,28,100,128,199,77,3,124,123,501
3014,Rahmon Fletcher,SR,2010-11,G,Green Bay,Horizon,32,1007,187,405,136,267,51,138,76,108,17,61,78,98,47,3,67,79,501
3015,Michael Flowers,SO,2018-19,G,Western Michigan,MAC,32,1003,151,390,86,194,65,196,134,171,10,114,124,104,28,4,99,77,501
3016,Warren Gillis,JR,2013-14,G,Coastal Carolina,Big South,34,1115,167,358,141,289,26,69,141,166,21,99,120,106,56,3,94,79,501
3017,Mike Groselle,JR,2011-12,C,Citadel,Southern,30,1059,198,335,198,335,0,0,105,154,117,171,288,54,43,19,65,88,501
3018,C.J. Harris,JR,2011-12,G,Wake Forest,ACC,30,1052,153,321,104,205,49,116,146,173,15,77,92,74,34,2,72,71,501
3019,Martin Hermannsson,SO,2015-16,G,Long Island University,NEC,31,1124,154,336,118,236,36,100,157,178,25,109,134,146,55,8,68,65,501
3020,Darrun Hilliard,SR,2014-15,G,Villanova,Big East,35,1007,170,386,91,182,79,204,82,103,16,93,109,74,63,12,42,78,501
3021,Damion James,SO,2007-08,F,Texas,Big 12,38,1185,193,419,155,327,38,92,77,135,119,274,393,51,26,51,59,97,501
3022,Matej Kavas,SO,2017-18,G,Seattle,WAC,33,1038,171,361,80,165,91,196,68,86,38,131,169,41,13,7,67,100,501
3023,Lorenzo Keeler,SR,2009-10,G,Cal Poly,Big West,31,1028,141,388,85,197,56,191,163,189,15,70,85,84,13,2,79,61,501
3024,Willie Mangum,SR,2016-17,G,Eastern Michigan,MAC,32,793,172,421,79,174,93,247,64,90,16,62,78,68,48,2,51,72,501
3025,Kennedy Meeks,SR,2016-17,F,North Carolina,ACC,40,973,206,371,206,371,0,0,89,143,152,226,378,41,38,47,48,94,501
3026,Paul Miller,JR,2016-17,G,North Dakota State,Summit,30,998,161,358,87,162,74,196,105,140,16,141,157,54,28,12,62,67,501
3027,Khalid Mutakabbir,SR,2012-13,G,Presbyterian,Big South,32,1192,175,410,112,243,63,167,88,105,21,77,98,79,36,3,95,55,501
3028,Drew Neitzel,SR,2007-08,G,Michigan State,Big Ten,36,1137,165,407,68,163,97,244,74,86,15,75,90,145,35,2,51,56,501
3029,Robert Nyakundi,JR,2010-11,F,Southern Methodist,CUSA,35,1071,166,345,69,150,97,195,72,80,35,116,151,67,36,6,83,108,501
3030,Greg Oden,FR,2006-07,C,Ohio State,Big Ten,32,925,189,307,189,307,0,0,123,196,113,193,306,21,18,105,64,87,501
3031,Otto Porter,SO,2012-13,F,Georgetown,Big East,31,1097,168,350,125,248,43,102,122,157,55,177,232,84,57,28,47,61,501
3032,Taylor Smith,SR,2012-13,F,Stephen F. Austin,Southland,32,1083,211,304,211,304,0,0,79,167,90,204,294,56,33,90,60,72,501
3033,Ladarius Tabb,JR,2014-15,G,Alabama A&M,SWAC,28,926,190,421,144,262,46,159,75,124,91,126,217,20,35,4,49,80,501
3034,Jeffery Taylor,JR,2010-11,F,Vanderbilt,SEC,34,1078,171,381,132,268,39,113,120,167,57,131,188,80,35,19,87,83,501
3035,Obie Trotter,SR,2005-06,G,Alabama A&M,SWAC,26,885,170,406,106,227,64,179,97,126,25,61,86,115,87,6,89,71,501
3036,Will Walker,SR,2009-10,G,DePaul,Big East,31,1180,177,494,106,263,71,231,76,107,23,70,93,79,48,4,52,54,501
3037,Jaylin Airington,SR,2016-17,F,Cal State Bakersfield,WAC,35,1108,161,388,117,268,44,120,134,168,52,111,163,71,28,3,65,90,500
3038,Josh Alexander,JR,2007-08,G,Stephen F. Austin,Southland,31,1022,157,360,63,131,94,229,92,123,56,128,184,35,45,11,45,75,500
3039,Devontae Cacok,SR,2018-19,F,North Carolina-Wilmington,CAA,33,951,203,344,202,343,1,1,93,155,132,273,405,21,31,22,74,115,500
3040,Eli Cain,SO,2016-17,G,DePaul,Big East,32,1059,169,425,118,277,51,148,111,154,32,112,144,85,33,12,76,85,500
3041,Jevon Carter,JR,2016-17,G,West Virginia,Big 12,37,1184,166,378,94,193,72,185,96,124,38,146,184,137,92,9,67,95,500
3042,Karl Cochran,SO,2012-13,G,Wofford,Southern,32,986,189,523,111,270,78,253,44,60,18,118,136,55,63,25,74,77,500
3043,Charles Cooke,JR,2015-16,G,Dayton,A-10,32,1029,163,365,104,217,59,148,115,167,43,144,187,58,40,38,56,61,500
3046,Louis Dabney,SO,2013-14,G,Tulane,CUSA,33,1069,160,386,131,283,29,103,151,214,33,103,136,66,41,3,80,97,500
3047,James Daniel,SO,2014-15,G,Howard,MEAC,30,972,140,414,72,176,68,238,152,186,15,50,65,81,55,0,108,56,500
3048,Ricky Franklin,SR,2009-10,G,Milwaukee,Horizon,34,1212,167,391,93,179,74,212,92,130,21,123,144,132,32,6,102,91,500
3049,Taj Gibson,JR,2008-09,F,Southern California,Pac-10,35,1179,190,316,190,316,0,0,120,182,123,193,316,44,34,100,72,103,500
3050,Jeremy Hollowell,SR,2016-17,F,Georgia State,Sun Belt,33,1015,175,411,116,235,59,176,91,121,33,163,196,57,32,25,85,102,500
3051,Dorenzo Hudson,JR,2009-10,G,Virginia Tech,ACC,33,1155,174,398,139,278,35,120,117,155,33,81,114,63,25,8,57,60,500
3052,Reginald Johnson,JR,2016-17,F,Alcorn State,SWAC,32,805,204,387,177,302,27,85,65,88,82,144,226,25,14,12,44,53,500
3053,C.J. Leslie,SO,2011-12,F,North Carolina State,ACC,34,985,192,366,188,352,4,14,112,188,74,175,249,37,36,54,79,87,500
3054,Maodo Lo,SO,2013-14,G,Columbia,Ivy,34,1096,172,359,96,189,76,170,80,96,18,112,130,70,42,11,68,79,500
3055,Damon Lynn,FR,2013-14,G,NJIT,Ind,29,981,151,405,44,123,107,282,91,117,15,65,80,60,35,1,53,32,500
3056,Jahmal McMurray,FR,2015-16,G,South Florida,AAC,33,1161,184,471,111,260,73,211,59,74,11,80,91,81,13,4,81,61,500
3057,K.C. Rivers,JR,2007-08,G,Clemson,ACC,34,1036,188,429,108,230,80,199,44,65,83,131,214,61,64,16,38,60,500
3058,D.J. Seeley,SR,2012-13,G,Cal State Fullerton,Big West,28,919,166,352,103,199,63,153,105,130,26,95,121,108,56,8,75,78,500
3059,Chad Tomko,SO,2008-09,G,North Carolina-Wilmington,CAA,32,1021,183,484,106,240,77,244,57,63,19,98,117,142,69,2,87,78,500
3060,Mikhail Torrance,SR,2009-10,G,Alabama,SEC,32,1043,163,347,124,238,39,109,135,156,10,109,119,162,26,8,86,49,500
3061,Ekpe Udoh,JR,2009-10,C,Baylor,Big 12,36,1264,191,390,184,364,7,26,111,162,129,222,351,97,29,133,87,87,500
3062,Kyle Weems,SR,2011-12,F,Missouri State,MVC,32,1005,182,440,121,289,61,151,75,96,56,173,229,44,19,20,60,95,500
3063,Michael Williams,SO,2010-11,G,San Francisco,WCC,34,1104,173,403,99,214,74,189,80,112,14,123,137,59,21,2,68,67,500
3064,Jermaine Anderson,SR,2005-06,G,Fordham,A-10,32,1102,159,371,70,156,89,215,92,108,34,84,118,109,21,5,69,50,499
3065,Tyree Appleby,SO,2018-19,G,Cleveland State,Horizon,29,885,147,350,73,160,74,190,131,168,10,98,108,162,42,9,100,48,499
3068,Aaron Bacote,SR,2015-16,G,Old Dominion,CUSA,38,993,157,366,110,229,47,137,138,169,13,96,109,82,32,6,59,86,499
3069,Grant Benzinger,SR,2017-18,G,Wright State,Horizon,35,1219,156,404,64,155,92,249,95,107,48,141,189,41,25,7,38,82,499
3070,Garfield Blair,JR,2007-08,G,Stetson,A-Sun,31,970,162,331,148,292,14,39,161,214,48,130,178,59,32,12,109,73,499
3071,Ryan Brooks,SR,2009-10,G,Temple,A-10,35,1266,179,433,123,257,56,176,85,103,22,126,148,82,27,3,43,51,499
3072,Jimmy Butler,JR,2009-10,G,Marquette,Big East,34,1165,148,279,132,247,16,32,187,244,82,134,216,68,45,21,39,68,499
3073,Kevin Criswell,SR,2005-06,G,Montana,Big Sky,31,978,147,308,77,138,70,170,135,166,22,113,135,73,41,3,52,81,499
3074,Kenneth Faried,SO,2008-09,F,Morehead State,OVC,36,1083,194,349,192,344,2,5,109,189,153,315,468,52,68,68,80,103,499
3075,Aaron Gray,SR,2006-07,C,Pittsburgh,Big East,36,1016,204,361,204,361,0,0,91,166,120,221,341,61,15,62,55,91,499
3076,Mike Green,JR,2006-07,G,Butler,Horizon,36,1247,138,333,111,245,27,88,196,264,40,176,216,144,45,0,102,95,499
3077,Scottie James,SO,2017-18,F,Liberty,Big South,37,943,189,307,174,261,15,46,106,141,94,235,329,41,15,33,50,80,499
3078,Matt Janning,SO,2007-08,G,Northeastern,CAA,31,1124,176,394,111,221,65,173,82,101,31,79,110,75,40,6,84,63,499
3079,Cory Johnson,JR,2009-10,F,Valparaiso,Horizon,32,953,180,324,159,283,21,41,118,174,68,117,185,47,33,17,76,89,499
3080,Lucky Jones,JR,2013-14,G,Robert Morris,NEC,36,1069,152,388,82,193,70,195,125,155,59,187,246,57,45,16,76,105,499
3081,Coby Karl,JR,2005-06,G,Boise State,WAC,29,974,150,351,80,174,70,177,129,162,22,125,147,117,30,14,105,81,499
3082,Marcus Keene,SO,2014-15,G,Youngstown State,Horizon,32,1117,167,372,76,155,91,217,74,94,13,100,113,88,35,3,68,80,499
3083,Sergio Kerusch,SR,2010-11,F,Western Kentucky,Sun Belt,32,992,193,398,147,248,46,150,67,104,101,152,253,15,13,12,45,89,499
3084,Dexter McClanahan,JR,2017-18,G,Savannah State,MEAC,32,945,166,407,96,175,70,232,97,133,37,98,135,61,39,6,56,60,499
3085,Donte McGill,JR,2015-16,G,Florida International,CUSA,31,1006,189,391,154,308,35,83,86,108,47,96,143,39,24,3,66,48,499
3086,Dan Nwaelele,SR,2006-07,F,Air Force,MWC,35,1128,163,316,87,147,76,169,97,119,25,97,122,64,31,8,59,60,499
3087,Herb Pope,SR,2011-12,F,Seton Hall,Big East,33,1036,193,410,176,362,17,48,96,156,113,230,343,48,36,56,87,100,499
3090,Darryl Proctor,JR,2007-08,F,Maryland-Baltimore County,AEC,33,1193,194,388,193,383,1,5,110,154,85,193,278,51,60,9,60,91,499
3091,Patrick Richard,JR,2010-11,G,McNeese State,Southland,31,1019,163,343,129,249,34,94,139,182,56,142,198,79,42,13,70,71,499
3092,Mike Rose,SO,2006-07,G,Eastern Kentucky,OVC,33,1084,168,380,80,159,88,221,75,98,35,90,125,61,52,4,57,42,499
3093,Patrick Sanders,SR,2007-08,F,UC-Irvine,Big West,33,1029,178,388,138,290,40,98,103,124,37,124,161,41,13,36,90,79,499
3094,Wesley Saunders,SR,2014-15,G,Harvard,Ivy,30,1032,164,362,133,289,31,73,140,181,51,131,182,128,55,11,78,66,499
3095,Jamar Smith,SR,2007-08,G,Morgan State,MEAC,30,899,191,410,163,325,28,85,89,125,60,103,163,37,29,17,60,74,499
3096,Joel Smith,SR,2012-13,G,Northeastern,CAA,31,1083,161,332,78,139,83,193,94,109,23,98,121,88,32,8,74,74,499
3097,Ricky Soliver,SR,2005-06,G,Iona,MAAC,31,1077,169,385,121,270,48,115,113,150,51,113,164,135,84,6,83,77,499
3098,Eric Stutz,SR,2014-15,F,Eastern Kentucky,OVC,32,1025,190,312,165,259,25,53,94,118,61,121,182,76,27,21,68,57,499
3099,Shayne Whittington,SR,2013-14,C,Western Michigan,MAC,31,987,188,357,182,324,6,33,117,152,74,201,275,34,24,47,58,74,499
3100,Rodney Williams,SR,2016-17,F,Drexel,CAA,32,973,184,350,181,337,3,13,128,190,80,137,217,48,15,27,72,112,499
3101,Ricky Woods,SR,2005-06,F,Southeastern Louisiana,Southland,28,939,171,349,170,344,1,5,156,246,108,196,304,60,57,47,82,84,499
3102,Ryan Arcidiacono,SR,2015-16,G,Villanova,Big East,40,1282,165,371,89,178,76,193,92,110,15,102,117,169,54,1,61,60,498
3103,Isaiah Bailey,JR,2017-18,G,Bethune-Cookman,MEAC,31,998,149,352,121,250,28,102,172,219,42,123,165,149,27,8,123,91,498
3104,Devon Baker,FR,2018-19,G,North Carolina-Asheville,Big South,31,1050,182,458,146,339,36,119,98,120,32,53,85,93,46,5,89,55,498
3105,Trae Bell-Haynes,SR,2017-18,G,Vermont,AEC,34,1089,166,325,144,262,22,63,144,197,21,125,146,138,38,4,106,80,498
3106,Jordan Bone,JR,2018-19,G,Tennessee,SEC,37,1219,186,400,136,259,50,141,76,91,19,99,118,215,26,4,74,49,498
3107,Barry Brown,SR,2018-19,G,Kansas State,Big 12,34,1189,184,425,142,284,42,141,88,124,14,125,139,96,65,5,65,73,498
3108,Jaylen Brown,FR,2015-16,F,University of California,Pac-12,34,939,163,378,133,276,30,102,142,217,36,146,182,68,27,22,105,108,498
3109,Mario Chalmers,JR,2007-08,G,Kansas,Big 12,39,1170,164,318,91,162,73,156,97,130,14,106,120,169,97,23,75,99,498
3112,D.J. Cooper,FR,2009-10,G,Ohio,MAC,37,1313,156,417,91,213,65,204,121,158,67,131,198,218,93,11,99,76,498
3113,Kenny Daniels,SR,2009-10,F,Cal State Northridge,Big West,32,882,163,323,135,234,28,89,144,180,45,88,133,61,34,4,108,84,498
3114,Cole Dickerson,SR,2013-14,F,San Francisco,WCC,33,1004,196,382,151,255,45,127,61,123,65,188,253,57,25,13,65,94,498
3115,Reggie Dillard,SR,2017-18,G,Presbyterian,Big South,32,1074,175,401,108,209,67,192,81,112,17,86,103,56,23,9,84,72,498
3116,Jordan Farmar,SO,2005-06,G,UCLA,Pac-10,37,1125,172,420,109,231,63,189,91,127,21,74,95,189,41,9,135,63,498
3117,Roderick Flemings,JR,2008-09,F,Hawaii,WAC,30,1079,166,356,144,285,22,71,144,198,79,95,174,56,35,13,77,64,498
3118,Bryn Forbes,SO,2013-14,G,Cleveland State,Horizon,32,1102,154,355,73,164,81,191,109,132,23,76,99,54,25,1,50,50,498
3119,Shane Gibson,SO,2010-11,G,Sacred Heart,NEC,29,945,173,393,98,200,75,193,77,92,32,84,116,45,40,18,77,68,498
3120,Grant Golden,FR,2017-18,F,Richmond,A-10,32,981,208,418,186,338,22,80,60,96,49,166,215,69,19,39,82,79,498
3121,Zachary Hamilton,JR,2016-17,F,Prairie View,SWAC,33,1006,163,387,83,187,80,200,92,111,27,109,136,34,40,16,43,84,498
3122,Keldon Johnson,FR,2018-19,G,Kentucky,SEC,37,1137,172,373,127,255,45,118,109,155,49,168,217,60,28,6,60,83,498
3123,Leland King,SR,2017-18,F,UC-Santa Barbara,Big West,32,1017,186,401,133,273,53,128,73,97,66,261,327,61,24,5,40,52,498
3124,Corey Lowe,JR,2008-09,G,Boston University,AEC,29,1060,174,405,89,177,85,228,65,106,19,98,117,120,36,4,97,67,498
3125,Demetri McCamey,SR,2010-11,G,Illinois,Big Ten,34,1137,166,367,92,203,74,164,92,127,17,98,115,208,35,6,100,67,498
3126,Travis McKie,SO,2011-12,F,Wake Forest,ACC,31,1070,175,366,142,279,33,87,115,156,70,146,216,34,26,18,76,72,498
3127,Mikh McKinney,JR,2013-14,G,Sacramento State,Big Sky,30,1038,173,359,135,249,38,110,114,139,24,89,113,138,37,6,68,71,498
3128,Cameron Moore,SR,2011-12,F,Alabama-Birmingham,CUSA,31,1111,195,404,190,381,5,23,103,168,88,237,325,39,19,73,64,63,498
3129,Larry Nance,SR,2014-15,F,Wyoming,MWC,31,1082,185,360,171,318,14,42,114,145,44,180,224,76,37,37,70,69,498
3130,Maurice Ndour,JR,2013-14,F,Ohio,MAC,36,1084,182,356,164,302,18,54,116,159,58,194,252,56,22,55,89,95,498
3131,Rian Pearson,SR,2013-14,G,Toledo,MAC,34,1049,191,399,162,331,29,68,87,130,69,111,180,59,59,4,49,56,498
3132,Jordan Roland,JR,2018-19,G,Northeastern,CAA,34,1038,167,370,68,124,99,246,65,72,16,65,81,58,40,8,30,68,498
3133,Jauwan Scaife,SR,2012-13,G,Ball State,MAC,30,994,145,367,75,156,70,211,138,175,16,63,79,77,29,5,72,57,498
3134,Stephen Thompson Jr.,SR,2018-19,G,Oregon State,Pac-12,31,1135,183,428,122,230,61,198,71,94,28,102,130,100,48,4,62,58,498
3135,Bernard Thompson,JR,2013-14,G,Florida Gulf Coast,A-Sun,33,1013,167,388,112,220,55,168,109,138,32,103,135,57,48,7,63,79,498
3136,Henry Walker,FR,2007-08,F,Kansas State,Big 12,31,846,181,389,146,275,35,114,101,137,79,117,196,59,27,17,81,101,498
3137,Antonio Webb,SR,2005-06,G,Bethune-Cookman,MEAC,30,1018,161,437,81,202,80,235,96,128,15,65,80,65,48,1,83,50,498
3138,Dez Wells,SO,2012-13,G,Maryland,ACC,38,1087,191,363,168,294,23,69,93,132,33,153,186,113,34,20,108,81,498
3139,Matthew Butler,SR,2017-18,G,Tennessee-Martin,OVC,31,1169,180,450,90,192,90,258,47,56,10,71,81,92,29,2,100,62,497
3140,Wilson Chandler,SO,2006-07,F,DePaul,Big East,34,1078,194,431,155,314,39,117,70,107,63,172,235,48,22,47,55,96,497
3141,Justin Cobbs,JR,2012-13,G,University of California,Pac-12,33,1174,172,384,146,304,26,80,127,151,12,102,114,158,37,6,97,60,497
3142,LaRon Dendy,SR,2011-12,F,Middle Tennessee,Sun Belt,34,937,175,330,163,291,12,39,135,235,70,173,243,70,22,48,83,91,497
3143,Gabe DeVoe,SR,2017-18,G,Clemson,ACC,35,1202,170,379,84,162,86,217,71,91,31,135,166,73,37,14,70,72,497
3144,Frank Elegar,JR,2006-07,C,Drexel,CAA,31,948,180,341,180,341,0,0,137,210,64,144,208,22,28,37,79,93,497
3145,Danny Green,SR,2008-09,F,North Carolina,ACC,38,1040,184,391,107,207,77,184,52,61,70,108,178,104,67,51,63,84,497
3146,Mike Green,SR,2007-08,G,Butler,Horizon,34,1144,141,327,108,238,33,89,182,240,41,179,220,172,44,4,100,84,497
3147,Shane Hammink,SR,2016-17,G,Valparaiso,Horizon,33,1042,169,338,128,214,41,124,118,146,30,100,130,81,34,11,84,63,497
3148,Maurice Harkless,FR,2011-12,G,St. John's (NY),Big East,32,1155,193,427,176,348,17,79,94,139,88,188,276,47,51,45,80,74,497
3149,Joseph Harris,SR,2009-10,F,Coastal Carolina,Big South,35,1082,200,383,197,376,3,7,94,151,110,226,336,48,65,32,53,76,497
3150,Nigel Hayes,SO,2014-15,F,Wisconsin,Big Ten,40,1319,166,334,126,233,40,101,125,168,85,162,247,79,34,16,51,76,497
3151,Jaycen Herring,SR,2008-09,F,Southeast Missouri State,OVC,30,1104,176,404,145,319,31,85,114,172,30,93,123,77,25,23,89,76,497
3154,Andre Hollins,SO,2012-13,G,Minnesota,Big Ten,34,1021,152,365,71,171,81,194,112,139,21,105,126,116,36,9,79,80,497
3155,Colton Iverson,SR,2012-13,F,Colorado State,MWC,35,1033,183,307,183,307,0,0,131,222,117,225,342,46,20,25,69,91,497
3156,JaJuan Johnson,SO,2008-09,F,Purdue,Big Ten,37,997,190,352,190,349,0,3,117,159,79,127,206,26,19,78,49,65,497
3157,Jerome Jordan,JR,2008-09,C,Tulsa,CUSA,36,971,180,307,180,307,0,0,137,186,88,220,308,34,14,91,87,110,497
3158,D.J. Kennedy,JR,2009-10,G,St. John's (NY),Big East,33,1037,158,351,107,218,51,133,130,172,58,144,202,102,38,22,82,57,497
3159,Preston Knowles,SR,2010-11,G,Louisville,Big East,34,1023,169,446,69,185,100,261,59,73,22,111,133,106,63,8,69,91,497
3160,Jeremy Lin,JR,2008-09,G,Harvard,Ivy,28,975,166,331,126,231,40,100,125,168,24,129,153,119,68,18,106,80,497
3161,LeAntwan Luckett,SO,2013-14,F,Alcorn State,SWAC,31,924,171,404,148,323,23,81,132,193,24,48,72,69,43,7,82,88,497
3162,Antoine Mason,FR,2011-12,G,Niagara,MAAC,33,1131,168,440,132,308,36,132,125,193,50,101,151,70,39,2,81,84,497
3163,Kyle McAlarney,JR,2007-08,G,Notre Dame,Big East,33,1178,167,383,59,138,108,245,55,67,8,61,69,115,26,1,66,34,497
3164,JD Notae,SO,2018-19,G,Jacksonville,A-Sun,32,933,177,415,115,221,62,194,81,111,29,168,197,109,52,14,106,76,497
3165,Miye Oni,JR,2018-19,G,Yale,Ivy,29,898,167,379,111,228,56,151,107,135,19,163,182,103,26,37,75,78,497
3166,Marcus Ottey,SO,2017-18,G,Illinois-Chicago,Horizon,36,1003,184,355,159,282,25,73,104,124,19,101,120,65,32,15,69,79,497
3167,Evan Payne,FR,2013-14,G,Loyola Marymount,WCC,32,956,171,394,133,284,38,110,117,139,33,54,87,46,42,6,86,70,497
3168,Jamal Shuler,SR,2007-08,G,Virginia Commonwealth,CAA,32,1058,172,391,94,202,78,189,75,94,26,123,149,40,48,8,49,56,497
3169,Khyri Thomas,JR,2017-18,G,Creighton,Big East,33,1046,184,342,122,191,62,151,67,85,35,109,144,92,56,8,59,62,497
3170,Kemba Walker,SO,2009-10,G,Connecticut,Big East,34,1197,152,377,114,265,38,112,155,202,32,113,145,172,70,15,99,59,497
3171,Russell Westbrook,SO,2007-08,G,UCLA,Pac-10,39,1318,182,391,156,314,26,77,107,150,61,92,153,167,63,7,96,93,497
3172,Marcus Williams,SO,2006-07,F,Arizona,Pac-10,30,987,196,397,173,317,23,80,82,118,63,137,200,67,33,23,80,66,497
3173,Martin Zeno,SR,2007-08,G,Texas Tech,Big 12,31,1062,166,351,161,322,5,29,160,212,31,109,140,91,43,17,87,56,497
3176,Devon Baker,SR,2010-11,G,Northwestern State,Southland,32,875,145,358,78,196,67,162,139,178,24,53,77,65,47,0,70,76,496
3177,Jarrell Brantley,SO,2016-17,F,College of Charleston,CAA,35,1120,170,370,139,286,31,84,125,165,61,233,294,43,39,24,90,102,496
3178,Vladimir Brodziansky,SR,2017-18,F,Texas Christian,Big 12,33,897,179,309,158,247,21,62,117,143,68,99,167,38,10,55,41,72,496
3179,Jawan Carter,SR,2010-11,G,Delaware,CAA,31,1105,134,351,50,130,84,221,144,170,19,95,114,74,27,1,65,75,496
3180,DeAndre Daniels,JR,2013-14,F,Connecticut,AAC,38,1103,188,401,138,281,50,120,70,89,55,173,228,17,26,54,56,90,496
3181,Keron DeShields,SR,2015-16,G,Tennessee State,OVC,30,983,166,383,118,250,48,133,116,156,10,88,98,91,39,5,63,74,496
3182,Gary Flowers,JR,2009-10,F,Southern Mississippi,CUSA,33,1034,203,437,178,361,25,76,65,98,83,190,273,45,26,60,81,92,496
3183,Rashid Gaston,JR,2014-15,F,Norfolk State,MEAC,32,983,204,326,204,326,0,0,88,162,106,200,306,45,8,37,66,89,496
3184,Daniel Gibson,SO,2005-06,G,Texas,Big 12,37,1228,163,402,62,136,101,266,69,95,42,91,133,116,49,12,70,88,496
3185,Kyle Gibson,SO,2007-08,G,Louisiana Tech,WAC,30,1081,162,386,97,222,65,164,107,144,34,115,149,39,33,9,62,84,496
3186,Marquez Haynes,JR,2008-09,G,Texas-Arlington,Southland,30,966,166,350,130,246,36,104,128,162,47,106,153,103,36,7,94,71,496
3187,Zaid Hearst,JR,2013-14,G,Quinnipiac,MAAC,32,1067,147,334,104,229,43,105,159,192,84,127,211,61,22,12,52,83,496
3188,Jesse Hunt,SR,2018-19,F,Eastern Washington,Big Sky,34,1102,173,355,123,236,50,119,100,133,52,245,297,112,19,22,68,96,496
3189,Ian Johnson,SR,2005-06,F,Davidson,Southern,31,963,199,382,165,302,34,80,64,83,49,148,197,27,10,5,38,68,496
3190,Rob Jones,SR,2011-12,F,Saint Mary's (CA),WCC,33,1110,194,415,160,292,34,123,74,115,106,251,357,75,52,21,73,74,496
3191,Darius Jones-Gibson,SR,2015-16,G,Samford,Southern,33,1078,158,329,142,283,16,46,164,231,15,79,94,114,32,7,101,82,496
3192,Kris Joseph,SR,2011-12,F,Syracuse,Big East,37,1192,164,390,113,242,51,148,117,157,56,118,174,56,50,23,55,62,496
3193,Quinn McDowell,JR,2010-11,G,William & Mary,CAA,32,1078,155,326,85,172,70,154,116,134,25,149,174,67,16,4,47,65,496
3194,Carlos Monroe,SO,2006-07,F,Florida Atlantic,Sun Belt,27,842,200,335,200,335,0,0,96,160,71,183,254,28,30,5,56,75,496
3195,Zane Najdawi,SO,2016-17,F,Citadel,Southern,33,791,157,334,129,269,28,65,154,185,93,127,220,26,33,38,73,113,496
3198,Stefan Nastic,SR,2014-15,C,Stanford,Pac-12,37,1098,179,379,179,379,0,0,138,183,90,149,239,53,13,38,75,137,496
3199,Jacob Parker,JR,2013-14,F,Stephen F. Austin,Southland,35,1010,175,325,152,276,23,49,123,154,86,161,247,70,48,19,42,100,496
3200,J.P. Primm,JR,2010-11,G,North Carolina-Asheville,Big South,34,1125,146,366,91,204,55,162,149,189,28,98,126,154,71,6,104,97,496
3201,Malachi Richardson,FR,2015-16,G,Syracuse,ACC,37,1272,152,412,73,188,79,224,113,157,19,139,158,77,42,10,79,91,496
3202,Steve Santa Ana,SR,2018-19,G,Elon,CAA,31,976,167,363,96,169,71,194,91,129,24,170,194,84,26,4,75,72,496
3203,Josh Slater,SR,2010-11,G,Lipscomb,A-Sun,30,933,151,352,117,234,34,118,160,222,56,127,183,139,93,6,92,86,496
3204,Isaiah Sykes,JR,2012-13,G,Central Florida,CUSA,31,1079,182,398,166,348,16,50,116,188,82,151,233,141,72,14,109,73,496
3205,Isaiah Taylor,SO,2015-16,G,Texas,Big 12,33,1019,159,379,140,318,19,61,159,196,14,78,92,164,29,7,61,88,496
3206,Jarvis Varnado,SR,2009-10,F,Mississippi State,SEC,36,1141,184,316,184,316,0,0,128,210,107,262,369,32,24,170,71,88,496
3207,Josiah Wallace,SO,2018-19,G,Eastern Illinois,OVC,32,1045,173,421,112,248,61,173,89,111,20,105,125,92,25,7,80,48,496
3208,Johnathan Williams,SR,2017-18,F,Gonzaga,WCC,37,1079,197,350,189,315,8,35,94,174,87,226,313,59,27,40,80,98,496
3209,Jay Youngblood,SR,2005-06,G,Kent State,MAC,34,1113,181,402,136,269,45,133,89,122,39,82,121,75,44,22,63,77,496
3210,Charles Bassey,FR,2018-19,C,Western Kentucky,CUSA,34,1067,188,300,179,280,9,20,110,143,99,241,340,24,27,81,97,88,495
3211,Devonte Brown,SR,2015-16,G,Indiana State,MVC,32,1051,138,372,116,277,22,95,197,260,32,123,155,88,31,9,110,77,495
3212,Eli Carter,SR,2015-16,G,Boston College,ACC,31,1034,174,469,110,240,64,229,83,106,11,110,121,125,37,7,106,59,495
3213,Wes Eikmeier,JR,2011-12,G,Colorado State,MWC,32,1046,166,412,111,263,55,149,108,123,4,55,59,65,25,2,68,67,495
3214,Ryan Evanochko,SR,2006-07,G,Green Bay,Horizon,33,1207,161,416,131,329,30,87,143,184,25,79,104,173,31,1,81,54,495
3215,Tarkus Ferguson,JR,2018-19,G,Illinois-Chicago,Horizon,32,1168,163,398,63,126,100,272,69,92,14,202,216,166,47,26,103,72,495
3216,Jerome Garrison,JR,2013-14,G,Grand Canyon,WAC,30,1134,128,306,76,176,52,130,187,236,18,66,84,64,14,10,60,75,495
3217,Chad Gray,SR,2010-11,F,Coastal Carolina,Big South,34,983,200,403,182,344,18,59,77,119,87,128,215,47,34,42,67,75,495
3220,P.J. Hairston,SO,2012-13,G,North Carolina,ACC,34,804,159,369,70,144,89,225,88,113,65,82,147,46,43,14,39,64,495
3221,Tim Hardaway,SO,2011-12,G,Michigan,Big Ten,34,1162,167,400,114,213,53,187,108,151,26,104,130,73,16,11,66,71,495
3222,Elias Harris,SR,2012-13,F,Gonzaga,WCC,34,944,169,337,161,290,8,47,149,194,69,184,253,53,40,19,60,67,495
3223,Andre Heard,SR,2005-06,G,Binghamton,AEC,29,1041,175,453,128,294,47,159,98,127,45,94,139,49,56,12,60,88,495
3224,Deion Holmes,JR,2017-18,G,South Carolina Upstate,A-Sun,32,848,186,397,134,244,52,153,71,92,48,71,119,42,16,3,85,58,495
3225,Travis Holmes,SO,2006-07,F,Virginia Military Institute,Big South,33,806,173,404,102,209,71,195,78,114,78,85,163,107,111,19,74,85,495
3226,Zak Irvin,SR,2016-17,G,Michigan,Big Ten,38,1345,195,430,141,273,54,157,51,76,23,149,172,113,34,2,71,46,495
3227,Christian James,SR,2018-19,G,Oklahoma,Big 12,34,1124,172,418,103,219,69,199,82,107,38,172,210,63,40,7,63,65,495
3228,Alize Johnson,SR,2017-18,F,Missouri State,MVC,33,1028,172,400,131,254,41,146,110,145,104,280,384,94,15,14,74,69,495
3229,Donte McGill,SR,2016-17,G,Florida International,CUSA,27,912,182,413,156,334,26,79,105,113,50,46,96,30,37,3,58,65,495
3230,James Nunnally,SR,2011-12,F,UC-Santa Barbara,Big West,31,1044,180,383,123,229,57,154,78,98,33,151,184,86,21,8,77,62,495
3231,Clifford Reed,FR,2008-09,G,Bethune-Cookman,MEAC,33,1224,163,466,110,278,53,188,116,161,15,87,102,129,39,2,114,64,495
3232,Brian Roberts,SO,2005-06,G,Dayton,A-10,31,1034,175,419,107,253,68,166,77,97,12,96,108,107,15,2,75,55,495
3233,Zack Rosen,SO,2009-10,G,Pennsylvania,Ivy,28,1039,140,319,69,152,71,167,144,167,21,71,92,124,32,0,92,78,495
3234,Malik Story,JR,2011-12,G,Nevada,WAC,35,1087,166,384,72,158,94,226,69,95,10,87,97,80,25,9,69,63,495
3235,Mike Taylor,JR,2006-07,G,Iowa State,Big 12,31,1086,165,439,88,225,77,214,88,129,22,104,126,140,35,3,168,89,495
3236,Micah Williams,SR,2010-11,G,East Tennessee State,A-Sun,35,1208,166,399,107,238,59,161,104,140,39,105,144,44,33,8,63,67,495
3237,Bam Adebayo,FR,2016-17,F,Kentucky,SEC,38,1145,170,284,170,284,0,0,154,236,118,186,304,32,26,57,64,99,494
3238,Corey Brewer,SO,2005-06,F,Florida,SEC,39,1095,171,365,129,245,42,120,110,143,51,135,186,128,61,16,108,97,494
3239,Armoni Brooks,JR,2018-19,G,Houston,AAC,37,1135,172,425,51,115,121,310,29,46,40,194,234,32,28,11,32,61,494
3240,Jamaal Brown,SR,2005-06,F,Cal State Fullerton,Big West,29,992,193,377,180,340,13,37,95,132,64,177,241,58,29,7,80,69,494
3241,James Carlton,SR,2014-15,G,Howard,MEAC,31,980,181,384,161,305,20,79,112,148,59,183,242,31,31,32,84,87,494
3242,Shannon Evans,JR,2016-17,G,Arizona State,Pac-12,33,1179,161,392,89,191,72,201,100,120,17,93,110,144,42,7,62,61,494
3243,Asante Gist,FR,2016-17,G,Eastern Kentucky,OVC,31,986,158,422,94,233,64,189,114,155,10,69,79,118,29,1,105,96,494
3244,A.J. Hammons,SR,2015-16,C,Purdue,Big Ten,33,813,199,336,193,325,6,11,90,127,77,193,270,37,9,84,65,78,494
3245,Sam Hauser,SO,2017-18,G,Marquette,Big East,35,1141,174,349,79,154,95,195,51,61,35,165,200,100,35,16,42,73,494
3246,Abdulai Jalloh,SO,2005-06,G,Saint Joseph's,A-10,33,998,132,352,81,203,51,149,179,213,40,142,182,85,41,9,91,111,494
3247,Christian Keeling,SO,2017-18,G,Charleston Southern,Big South,28,941,169,397,124,254,45,143,111,140,22,123,145,57,37,12,67,69,494
3248,Marcelus Kemp,SO,2005-06,G,Nevada,WAC,33,859,178,385,126,240,52,145,86,101,26,81,107,44,15,8,60,63,494
3249,Carl Krauser,SR,2005-06,G,Pittsburgh,Big East,33,1054,157,391,90,209,67,182,113,155,26,115,141,160,53,0,103,92,494
3250,Ron Lewis,SR,2006-07,G,Ohio State,Big Ten,39,1124,152,356,88,170,64,186,126,162,29,111,140,50,37,13,63,48,494
3251,Frantz Massenat,SO,2011-12,G,Drexel,CAA,36,1287,147,343,93,223,54,120,146,187,17,95,112,173,32,13,77,84,494
3252,Tony Murphy,JR,2006-07,G,Norfolk State,MEAC,30,1052,170,418,91,211,79,207,75,96,24,90,114,43,29,4,86,33,494
3253,DeMarcus Nelson,SR,2007-08,G,Duke,ACC,34,1051,172,351,132,248,40,103,110,183,49,148,197,100,53,11,84,77,494
3254,B.J. Raymond,SR,2008-09,F,Xavier,A-10,35,1060,167,365,83,160,84,205,76,94,18,127,145,50,18,12,55,69,494
3255,Stanley Robinson,SR,2009-10,F,Connecticut,Big East,34,1163,203,387,176,308,27,79,61,97,91,169,260,34,30,41,77,52,494
3256,Romone Saunders ,SR,2018-19,G,Wagner,NEC,30,1038,143,386,79,187,64,199,144,171,65,152,217,109,46,8,83,88,494
3257,Tyler Seibring,JR,2017-18,F,Elon,CAA,32,1090,183,373,101,182,82,191,46,65,48,168,216,70,9,21,35,49,494
3258,Marcus Slaughter,JR,2005-06,F,San Diego State,MWC,30,982,151,308,151,307,0,1,192,252,124,205,329,56,36,31,86,94,494
3259,Nick Stallings,JR,2007-08,G,Centenary (LA),Summit,31,,170,399,134,306,36,93,118,155,,,151,75,45,12,81,,494
3262,Jonathan Stark,FR,2013-14,G,Tulane,CUSA,34,1264,160,384,115,266,45,118,129,173,12,77,89,143,29,1,84,64,494
3263,Justin Strings,JR,2016-17,F,Sacramento State,Big Sky,31,1021,179,424,124,267,55,157,81,133,37,133,170,32,12,11,47,69,494
3264,Jameel Warney,SO,2013-14,F,Stony Brook,AEC,34,1001,204,331,204,331,0,0,86,142,97,176,273,66,25,42,43,75,494
3265,Jamel Waters,SR,2015-16,G,Alabama State,SWAC,31,1057,160,390,84,206,76,184,98,134,32,102,134,134,54,2,81,65,494
3266,Antwaine Wiggins,SR,2011-12,F,College of Charleston,Southern,31,1082,176,401,116,233,60,168,82,142,78,122,200,67,35,14,73,44,494
3267,Ruben Boykin,SR,2006-07,F,Northern Arizona,Big Sky,30,955,182,353,163,309,19,44,110,143,74,194,268,93,23,16,74,82,493
3268,Kyle Cain,JR,2013-14,F,North Carolina-Greensboro,Southern,32,973,201,422,192,391,9,31,82,115,77,208,285,37,22,11,64,72,493
3269,Daniel Emerson,SR,2009-10,F,Mercer,A-Sun,32,1090,162,298,148,265,14,33,155,210,127,258,385,45,25,5,89,64,493
3270,Brandon Fields,SR,2009-10,G,Nevada,WAC,34,1150,174,404,110,212,64,192,81,131,15,117,132,83,33,10,56,42,493
3271,Donovan Fields,SR,2018-19,G,Cal Poly,Big West,29,978,189,476,149,345,40,131,75,90,17,55,72,118,41,10,66,70,493
3272,Keith Gabriel,SO,2009-10,G,Virginia Military Institute,Big South,28,722,165,404,81,142,84,262,79,115,27,71,98,35,55,23,50,68,493
3273,Seth Hinrichs,SO,2012-13,G,Lafayette,Patriot,34,974,159,345,81,174,78,171,97,126,47,119,166,60,21,5,61,49,493
3274,Tony Hooper,SO,2006-07,G,Louisiana-Monroe,Sun Belt,32,995,169,421,93,199,76,222,79,107,28,94,122,86,53,6,101,101,493
3275,Othyus Jeffers,JR,2006-07,F,Illinois-Chicago,Horizon,32,1055,179,382,177,370,2,12,133,200,102,174,276,82,53,7,92,83,493
3276,Brent Jones,SR,2014-15,G,St. Francis (NY),NEC,35,1188,157,396,107,244,50,152,129,167,28,91,119,184,66,3,120,68,493
3277,Derrick Low,SR,2007-08,G,Washington State,Pac-10,35,1164,166,384,74,145,92,239,69,88,8,54,62,55,50,3,43,60,493
3278,Myles Mack,JR,2013-14,G,Rutgers,AAC,33,1008,156,387,86,198,70,189,111,124,19,71,90,142,54,6,87,70,493
3279,Denzel Mahoney,FR,2016-17,G,Southeast Missouri State,OVC,33,976,152,339,95,188,57,151,132,162,47,93,140,40,23,4,45,106,493
3280,Julian Mavunga,SR,2011-12,F,Miami (OH),MAC,30,1107,150,340,125,258,25,82,168,229,66,204,270,101,27,17,120,73,493
3281,JayQuan McCloud,JR,2018-19,G,Green Bay,Horizon,36,978,166,373,89,177,77,196,84,101,21,77,98,82,26,12,59,76,493
3284,Nic Moore,JR,2014-15,G,Southern Methodist,AAC,34,1179,156,371,79,186,77,185,104,117,8,70,78,175,43,1,87,64,493
3285,Vince Oliver,SR,2008-09,G,UC-Davis,Big West,32,1048,177,367,134,243,43,124,96,118,23,76,99,85,30,2,84,63,493
3286,Richaud Pack,SR,2013-14,G,North Carolina A&T,MEAC,29,992,128,290,76,154,52,136,185,230,44,88,132,46,19,2,50,59,493
3287,Carson Puriefoy,SR,2015-16,G,Stony Brook,AEC,33,1113,156,400,73,191,83,209,98,126,21,85,106,103,40,13,81,75,493
3288,Mykal Riley,SR,2007-08,F,Alabama,SEC,33,1039,168,375,65,137,103,238,54,72,46,124,170,58,54,19,58,68,493
3289,Justin Roberson,SR,2015-16,G,Louisiana-Monroe,Sun Belt,34,1128,182,384,140,283,42,101,87,127,28,131,159,93,57,4,75,109,493
3290,Quinton Rose,SO,2017-18,G,Temple,AAC,33,1064,190,438,141,296,49,142,64,98,24,118,142,75,49,6,80,56,493
3291,Omar Samhan,JR,2008-09,C,Saint Mary's (CA),WCC,35,1036,197,353,197,352,0,1,99,136,134,194,328,57,14,69,64,98,493
3292,Brenton Scott,JR,2016-17,G,Indiana State,MVC,31,980,165,441,92,235,73,206,90,132,10,141,151,74,50,5,57,63,493
3293,Josh Scott,SO,2013-14,F,Colorado,Pac-12,35,1107,159,311,159,309,0,2,175,216,102,193,295,22,28,40,51,63,493
3294,Xavier Silas,JR,2009-10,G,Northern Illinois,MAC,25,789,141,369,89,207,52,162,159,196,37,95,132,41,20,12,60,81,493
3295,Tony Tate,SR,2005-06,G,Florida A&M,MEAC,30,,149,359,92,207,57,152,138,167,31,64,95,93,73,0,106,67,493
3296,Trey Thompkins,JR,2010-11,F,Georgia,SEC,30,937,194,403,171,329,23,74,82,119,56,173,229,42,33,50,76,67,493
3297,Andre Walker,JR,2016-17,G,Loyola (MD),Patriot,33,1075,152,431,70,215,82,216,107,124,19,99,118,128,50,10,110,88,493
3298,James Woodard,JR,2014-15,G,Tulsa,AAC,34,1174,158,388,70,150,88,238,89,126,18,149,167,38,30,8,46,55,493
3299,Grayson Allen,JR,2016-17,G,Duke,ACC,34,1007,141,357,60,135,81,222,129,159,23,104,127,119,26,2,74,78,492
3300,Darian Anderson,JR,2016-17,G,Fairleigh Dickinson,NEC,29,971,165,396,108,241,57,155,105,128,21,89,110,94,58,7,61,75,492
3301,Aaron Broussard,SR,2011-12,F,Seattle,Ind,27,789,184,394,149,287,35,107,89,124,77,99,176,27,43,2,48,62,492
3302,Robert Brown,JR,2014-15,G,Alabama-Birmingham,CUSA,36,1165,176,438,115,251,61,187,79,107,29,103,132,109,37,9,75,62,492
3303,Norris Cole,SO,2008-09,G,Cleveland State,Horizon,37,1213,187,413,147,282,40,131,78,97,38,56,94,90,44,5,56,87,492
3306,Vincent Council,JR,2011-12,G,Providence,Big East,31,1200,184,471,155,372,29,99,95,141,30,96,126,231,39,11,109,75,492
3307,Daviyon Draper,SR,2015-16,F,Florida International,CUSA,31,1089,195,430,162,346,33,84,69,98,44,173,217,68,31,20,85,76,492
3308,Marc Egerson,SR,2008-09,G,Delaware,CAA,32,1165,153,380,96,231,57,149,129,174,57,274,331,84,44,6,93,70,492
3309,Evan Fisher,SR,2018-19,F,Siena,MAAC,31,1032,205,420,190,355,15,65,67,93,34,151,185,46,6,15,52,49,492
3310,Jeremy Goode,JR,2008-09,G,Mount St. Mary's,NEC,33,1140,166,403,121,282,45,121,115,179,34,70,104,134,62,1,78,54,492
3311,Vince Hunter,SO,2014-15,F,Texas-El Paso,CUSA,33,940,182,346,178,336,4,10,124,207,88,217,305,55,41,34,92,98,492
3312,Ibrahim Jaaber,SR,2006-07,G,Pennsylvania,Ivy,31,1144,187,361,154,249,33,112,85,129,52,86,138,160,90,17,91,69,492
3313,Cory Jefferson,JR,2012-13,F,Baylor,Big 12,37,1032,191,313,188,304,3,9,107,152,99,196,295,11,17,71,30,85,492
3314,Brice Johnson,JR,2014-15,F,North Carolina,ACC,38,940,207,366,207,366,0,0,78,115,89,206,295,35,26,42,58,112,492
3315,Ravern Johnson,SR,2010-11,G,Mississippi State,SEC,28,978,162,377,79,171,83,206,85,109,22,78,100,21,12,15,36,28,492
3316,John Konchar,SO,2016-17,G,Purdue-Fort Wayne,Summit,33,1153,188,295,143,208,45,87,71,103,79,209,288,126,55,15,51,61,492
3317,Cameron Morse,SR,2017-18,G,Youngstown State,Horizon,32,1024,174,466,95,229,79,237,65,83,11,62,73,124,35,6,65,45,492
3318,Arnett Moultrie,JR,2011-12,F,Mississippi State,SEC,30,1073,180,328,172,310,8,18,124,159,110,204,314,35,25,23,73,67,492
3319,Deondre Parks,JR,2014-15,G,South Dakota State,Summit,35,1113,167,391,98,201,69,190,89,118,17,125,142,67,22,3,62,85,492
3320,Deondre Parks,SR,2015-16,G,South Dakota State,Summit,33,1069,164,388,113,238,51,150,113,139,25,127,152,50,26,7,56,74,492
3321,Payton Pritchard,JR,2018-19,G,Oregon,Pac-12,38,1349,167,400,102,202,65,198,93,111,33,114,147,175,68,3,75,83,492
3322,Jason Rich,SR,2007-08,G,Florida State,ACC,34,1155,183,410,152,321,31,89,95,123,39,109,148,69,39,9,96,97,492
3323,Mike Schachtner,SO,2006-07,F,Green Bay,Horizon,33,1043,168,341,116,227,52,114,104,114,41,90,131,20,17,6,48,71,492
3324,Jaaron Simmons,JR,2016-17,G,Ohio,MAC,31,1116,176,406,139,299,37,107,103,142,14,96,110,200,29,2,123,72,492
3325,Justin Turner,FR,2017-18,G,Bowling Green State,MAC,31,1051,169,416,119,284,50,132,104,128,26,87,113,81,47,9,74,56,492
3328,Michael Van Schaick,SR,2006-07,G,Fairfield,MAAC,32,1116,154,344,66,122,88,222,96,112,51,75,126,63,38,7,48,58,492
3329,Maurice Watson Jr.,JR,2015-16,G,Creighton,Big East,35,1100,179,377,160,313,19,64,115,161,21,97,118,228,34,1,115,89,492
3330,Justise Winslow,FR,2014-15,F,Duke,ACC,39,1135,173,356,127,246,46,110,100,156,49,203,252,82,52,34,71,108,492
3331,Jeff Adrien,SR,2008-09,F,Connecticut,Big East,36,1245,190,376,190,375,0,1,111,186,115,243,358,60,19,42,65,72,491
3332,Al-Farouq Aminu,SO,2009-10,F,Wake Forest,ACC,31,970,167,374,149,308,18,66,139,199,133,199,332,41,44,44,99,91,491
3333,Darion Anderson,SO,2008-09,G,Northern Illinois,MAC,29,914,159,383,113,259,46,124,127,189,36,121,157,70,46,4,92,70,491
3334,Ron Baker,SR,2015-16,G,Wichita State,MVC,35,1106,160,377,96,194,64,183,107,135,19,149,168,113,53,21,54,50,491
3335,James Bell,SR,2013-14,G,Villanova,Big East,34,1004,159,373,74,144,85,229,88,108,52,154,206,55,44,21,59,104,491
3336,Tristan Blackwood,SR,2007-08,G,Central Connecticut State,NEC,30,1078,158,390,53,106,105,284,70,81,23,58,81,155,36,3,107,57,491
3337,Trevor Booker,JR,2008-09,F,Clemson,ACC,32,982,189,331,180,309,9,22,104,147,107,204,311,54,47,63,59,54,491
3338,Al'lonzo Coleman,SR,2011-12,C,Presbyterian,Big South,29,883,163,302,161,291,2,11,163,249,77,177,254,51,33,13,85,95,491
3339,Ryan Evanochko,JR,2005-06,G,Green Bay,Horizon,31,1130,170,382,140,296,30,86,121,155,24,85,109,160,23,6,84,57,491
3340,Dwayne Evans,JR,2012-13,F,Saint Louis,A-10,35,1036,170,311,165,292,5,19,146,190,84,186,270,37,44,25,62,92,491
3341,LJ Figueroa,SO,2018-19,G,St. John's (NY),Big East,34,1087,199,388,148,255,51,133,42,67,52,164,216,57,61,7,45,85,491
3342,Chris Flores,SR,2012-13,G,NJIT,GWC,29,966,159,408,89,207,70,201,103,135,26,88,114,83,69,7,82,72,491
3343,Nick George,SR,2005-06,F,Virginia Commonwealth,CAA,29,857,167,357,115,246,52,111,105,147,44,103,147,37,37,4,86,38,491
3344,Tyrone Hamilton,SO,2006-07,G,Centenary (LA),Mid-Cont,31,,159,422,92,231,67,191,106,133,,,92,103,33,3,,,491
3345,Deontae Hawkins,SR,2016-17,F,Illinois State,MVC,35,956,186,396,116,238,70,158,49,63,60,168,228,40,26,25,50,93,491
3346,Connor Hill,SR,2014-15,G,Idaho,Big Sky,30,921,164,365,56,125,108,240,55,65,15,53,68,20,15,0,30,56,491
3347,Brad Loesing,SR,2011-12,G,Wofford,Southern,33,1265,170,410,117,247,53,163,98,123,12,86,98,184,36,3,114,92,491
3348,Mike Moore,JR,2010-11,G,Hofstra,CAA,33,1106,157,386,95,211,62,175,115,135,38,141,179,73,32,6,56,76,491
3349,Kevin Murphy,SO,2009-10,G,Tennessee Tech,OVC,32,1003,170,385,133,264,37,121,114,151,37,88,125,66,23,4,90,75,491
3350,Emmett Naar,SO,2015-16,G,Saint Mary's (CA),WCC,35,1301,171,351,115,217,56,134,93,107,22,106,128,222,45,5,80,45,491
3351,Andrew Nicholson,SO,2009-10,F,St. Bonaventure,A-10,30,907,198,351,198,351,0,0,95,125,72,141,213,15,6,55,55,90,491
3352,Victor Oladipo,JR,2012-13,G,Indiana,Big Ten,36,1021,182,304,152,236,30,68,97,130,93,134,227,74,78,28,83,89,491
3353,Davon Reed,SR,2016-17,G,Miami (FL),ACC,33,1165,161,372,82,173,79,199,90,108,28,130,158,79,43,16,67,52,491
3354,Kevin Rogers,SR,2008-09,F,Baylor,Big 12,39,1285,200,358,200,356,0,2,91,145,98,198,296,42,31,31,87,98,491
3355,Earnest Ross,SR,2013-14,G,Missouri,SEC,35,1116,141,343,84,160,57,183,152,196,42,169,211,49,46,13,66,69,491
3356,Dustin Salisbery,SR,2006-07,G,Temple,A-10,30,994,169,398,113,240,56,158,97,143,36,115,151,73,48,11,88,104,491
3357,JaKarr Sampson,FR,2012-13,F,St. John's (NY),Big East,33,1040,202,450,202,442,0,8,87,136,72,146,218,35,36,36,66,91,491
3358,Lavelle Scottie,JR,2018-19,F,Air Force,MWC,32,1005,202,415,169,304,33,111,54,89,42,136,178,42,23,8,96,66,491
3359,Nate Sestina,SR,2018-19,F,Bucknell,Patriot,31,861,185,345,144,237,41,108,80,99,61,201,262,37,11,33,66,89,491
3360,Ben Smith,SO,2007-08,G,Jacksonville,A-Sun,31,1126,127,326,80,199,47,127,190,224,31,83,114,143,56,4,91,49,491
3361,Quinton Upshur,JR,2013-14,G,Northern Arizona,Big Sky,32,942,158,357,85,166,73,191,102,142,11,94,105,27,52,21,61,83,491
3362,Glynn Watson Jr.,SR,2018-19,G,Nebraska,Big Ten,36,1241,178,430,96,216,82,214,53,67,16,132,148,112,40,4,51,89,491
3363,Kyle Weems,SO,2009-10,F,Missouri State,MVC,36,1037,180,379,108,202,72,177,59,76,39,184,223,65,49,37,38,108,491
3364,Davis Baker,SR,2009-10,G,Southern Utah,Summit,29,984,175,380,146,298,29,82,111,130,25,131,156,27,27,6,74,54,490
3365,Levi Bradley,SR,2018-19,F,Northern Illinois,MAC,34,994,185,374,155,291,30,83,90,109,51,127,178,44,22,9,50,89,490
3366,Corey Brewer,JR,2006-07,F,Florida,SEC,37,1053,169,356,129,237,40,119,112,155,40,133,173,109,69,15,93,72,490
3367,Elijah Brown,JR,2017-18,G,Oregon,Pac-12,36,1050,159,382,67,129,92,253,80,86,26,94,120,90,27,1,67,66,490
3370,Jordan Burns,SO,2018-19,G,Colgate,Patriot,30,987,167,381,89,183,78,198,78,95,13,78,91,171,36,3,94,51,490
3371,Nik Caner-Medley,SR,2005-06,F,Maryland,ACC,32,1036,166,365,139,289,27,76,131,159,72,128,200,68,39,16,74,59,490
3372,C.J. Carter,SR,2014-15,G,Omaha,Summit,29,995,176,388,128,239,48,149,90,127,13,54,67,78,43,19,85,70,490
3373,Ja'Vance Coleman,JR,2005-06,G,Fresno State,WAC,28,913,152,395,57,148,95,247,91,114,16,64,80,61,26,8,68,59,490
3374,Larry Cunningham,SR,2007-08,G,UC-Riverside,Big West,30,890,162,402,109,238,53,164,113,137,4,86,90,42,44,9,78,61,490
3375,Jason Dunne,JR,2017-18,G,Hartford,AEC,33,1172,169,406,71,132,98,274,54,72,17,106,123,92,42,8,74,76,490
3376,Grayson Flittner,SO,2007-08,G,Gardner-Webb,A-Sun,32,1037,146,360,39,94,107,266,91,112,23,68,91,120,34,2,65,67,490
3377,Darrion Griffin,SR,2008-09,G,Jackson State,SWAC,33,978,159,320,143,260,16,60,156,213,67,121,188,94,45,5,79,69,490
3378,LaDontae Henton,JR,2013-14,F,Providence,Big East,35,1299,168,377,120,243,48,134,106,142,86,190,276,59,46,20,55,83,490
3379,Anthony Hill,SR,2010-11,F,Milwaukee,Horizon,32,900,172,325,171,321,1,4,145,205,90,122,212,46,14,19,77,108,490
3380,Taveion Hollingsworth,SO,2018-19,G,Western Kentucky,CUSA,34,1251,175,419,126,265,49,154,91,118,35,115,150,76,41,8,72,49,490
3381,Joe Jackson,JR,2012-13,G,Memphis,CUSA,36,1175,168,324,130,239,38,85,116,159,17,103,120,173,60,7,102,73,490
3382,Curtis Jerrells,JR,2007-08,G,Baylor,Big 12,32,997,165,387,110,222,55,165,105,140,20,91,111,121,42,6,68,58,490
3383,Anthony Johnson,JR,2015-16,G,Northern Colorado,Big Sky,31,896,157,353,91,184,66,169,110,128,38,104,142,26,22,8,61,74,490
3384,James Kinney,JR,2011-12,G,San Jose State,WAC,31,963,170,420,84,204,86,216,64,75,24,88,112,85,40,5,92,60,490
3385,Tyler Kohl,SR,2018-19,F,Central Connecticut State,NEC,27,925,155,393,114,269,41,124,139,164,45,143,188,123,38,1,100,63,490
3386,John Konchar,JR,2017-18,G,Purdue-Fort Wayne,Summit,33,1180,177,367,111,195,66,172,70,108,66,201,267,156,81,23,54,61,490
3387,Kyle Lofton,FR,2018-19,G,St. Bonaventure,A-10,34,1272,177,401,139,286,38,115,98,117,30,55,85,127,48,2,64,72,490
3388,Marc Loving,JR,2015-16,F,Ohio State,Big Ten,35,1189,152,367,96,202,56,165,130,172,43,141,184,54,22,14,82,59,490
3389,Kalin Lucas,JR,2009-10,G,Michigan State,Big Ten,33,1027,165,364,130,265,35,99,125,162,22,40,62,131,40,2,80,49,490
3392,LeAntwan Luckett,JR,2014-15,F,Alcorn State,SWAC,30,1031,158,424,111,272,47,152,127,181,52,51,103,52,40,13,68,86,490
3393,Troyce Manassa,SR,2016-17,G,Savannah State,MEAC,29,798,161,363,97,182,64,181,104,145,37,111,148,84,30,7,62,73,490
3394,Davon Marshall,JR,2012-13,G,Liberty,Big South,36,1158,154,346,47,98,107,248,75,88,9,66,75,101,27,2,73,42,490
3395,Mike Moser,SO,2011-12,F,Nevada-Las Vegas,MWC,35,1098,184,409,140,276,44,133,78,100,92,277,369,80,68,35,102,95,490
3396,Emmanuel Omogbo,SR,2016-17,F,Colorado State,MWC,36,1095,171,355,140,266,31,89,117,176,101,272,373,62,38,23,69,98,490
3397,Durand Scott,SO,2010-11,G,Miami (FL),ACC,36,1182,162,364,135,295,27,69,139,166,42,110,152,112,43,4,100,93,490
3398,TJ Shorts II,JR,2017-18,G,UC-Davis,Big West,33,1043,161,309,151,280,10,29,158,212,12,111,123,146,63,8,81,69,490
3399,James Thompson IV,FR,2015-16,C,Eastern Michigan,MAC,33,1058,182,282,182,281,0,1,126,184,148,203,351,20,25,47,48,117,490
3400,Lucas Troutman,SR,2013-14,F,Elon,Southern,31,896,185,350,184,349,1,1,119,168,49,143,192,25,23,58,65,70,490
3401,Okaro White,SR,2013-14,F,Florida State,ACC,36,1084,166,323,142,259,24,64,134,168,75,168,243,34,27,40,68,108,490
3402,Jeff Adrien,JR,2007-08,F,Connecticut,Big East,33,1115,173,345,171,341,2,4,141,229,86,216,302,42,16,41,89,64,489
3403,Manny Atkins,SR,2013-14,F,Georgia State,Sun Belt,34,1136,153,324,78,151,75,173,108,131,31,177,208,48,46,24,43,78,489
3404,Ryan Bathie,SR,2008-09,G,Nicholls State,Southland,31,944,180,362,124,201,56,161,73,94,46,106,152,68,35,12,64,90,489
3405,Ryan Daly,SO,2017-18,G,Delaware,CAA,28,1049,178,413,132,265,46,148,87,137,40,133,173,67,33,3,35,60,489
3406,Sam Dower,SR,2013-14,C,Gonzaga,WCC,34,898,185,324,179,305,6,19,113,137,64,181,245,37,15,24,53,81,489
3407,Malachi Flynn,SO,2017-18,G,Washington State,Pac-12,31,1035,162,392,85,164,77,228,88,104,22,84,106,132,49,2,66,56,489
3408,Andre Hollins,JR,2013-14,G,Minnesota,Big Ten,36,1099,137,363,70,171,67,192,148,176,26,100,126,87,32,3,65,91,489
3409,Nick Honor,FR,2018-19,G,Fordham,A-10,32,1154,174,467,104,256,70,211,71,87,18,58,76,95,28,0,54,60,489
3410,Cody John,JR,2018-19,G,Weber State,Big Sky,33,1049,183,379,143,262,40,117,83,108,10,114,124,71,16,5,63,76,489
3411,Zane Johnson,JR,2010-11,G,Hawaii,WAC,31,1059,157,359,59,118,98,241,77,95,7,90,97,58,17,4,66,83,489
3414,Marcel Jones,JR,2006-07,F,Oregon State,Pac-10,32,1000,196,435,156,302,40,133,57,105,50,131,181,41,49,12,72,68,489
3415,Jalen Jordan,SO,2018-19,G,St. Francis (NY),NEC,33,1033,156,364,67,152,89,212,88,109,15,103,118,48,16,8,54,51,489
3416,Mfiondu Kabengele,SO,2018-19,F,Florida State,ACC,37,798,164,327,140,262,24,65,137,180,79,141,220,11,21,56,48,96,489
3417,Frank Mason,JR,2015-16,G,Kansas,Big 12,38,1272,155,357,112,244,43,113,136,184,27,136,163,175,50,3,73,84,489
3418,Marcel Mosley,SR,2014-15,G,Arkansas-Pine Bluff,SWAC,28,997,145,360,76,179,69,181,130,159,23,58,81,73,58,0,97,53,489
3419,Tyler Smith,SO,2007-08,F,Tennessee,SEC,36,1017,181,338,167,301,14,37,113,160,94,148,242,122,50,20,79,92,489
3420,Michael Snaer,JR,2011-12,G,Florida State,ACC,35,1065,167,383,100,217,67,166,88,104,33,99,132,68,39,13,72,69,489
3421,Michael Snaer,SR,2012-13,G,Florida State,ACC,33,1079,155,365,92,201,63,164,116,142,22,125,147,82,33,15,91,81,489
3422,Hasheem Thabeet,JR,2008-09,C,Connecticut,Big East,36,1145,178,278,178,278,0,0,133,212,133,255,388,17,22,152,68,90,489
3423,Chris Vann,SR,2007-08,G,Mount St. Mary's,NEC,34,1001,168,394,80,165,88,229,65,78,19,81,100,40,20,0,44,81,489
3424,James Webb,JR,2015-16,F,Boise State,MWC,31,944,177,358,150,249,27,109,108,158,74,209,283,34,44,20,49,94,489
3425,Akwasi Yeboah,SO,2017-18,G,Stony Brook,AEC,32,912,156,345,97,179,59,166,118,147,30,132,162,44,28,7,74,81,489
3426,Tyler Bey,SO,2018-19,G,Colorado,Pac-12,36,948,184,340,179,318,5,22,115,147,77,278,355,23,30,44,71,83,488
3427,Mario Boggan,JR,2005-06,F,Oklahoma State,Big 12,33,909,182,313,173,285,9,28,115,140,80,107,187,33,37,27,72,100,488
3428,Ben Brust,SR,2013-14,G,Wisconsin,Big Ten,38,1318,156,373,60,129,96,244,80,89,31,140,171,50,29,2,27,36,488
3429,Reggie Bullock,JR,2012-13,G,North Carolina,ACC,35,1100,172,356,84,154,88,202,56,73,71,155,226,101,44,10,43,50,488
3430,Marcus Burk,SO,2017-18,G,Campbell,Big South,33,1048,173,353,82,127,91,226,51,60,21,99,120,38,42,8,45,58,488
3431,Jackie Carmichael,JR,2011-12,F,Illinois State,MVC,35,1018,168,315,166,311,2,4,150,210,79,259,338,35,21,50,77,94,488
3432,Charles Cooper,JR,2015-16,G,Green Bay,Horizon,36,962,160,340,152,304,8,36,160,232,59,139,198,53,37,6,75,65,488
3433,Will Cummings,JR,2013-14,G,Temple,AAC,29,998,158,353,126,249,32,104,140,178,30,68,98,132,43,3,65,92,488
3436,Terence Dials,SR,2005-06,F,Ohio State,Big Ten,32,974,194,347,194,346,0,1,100,152,82,175,257,19,29,35,63,86,488
3437,Adrian Diaz,SR,2015-16,F,Florida International,CUSA,32,953,180,277,180,277,0,0,128,206,102,149,251,28,20,93,68,113,488
3438,Chase Fieler,SR,2013-14,F,Florida Gulf Coast,A-Sun,35,1003,187,341,169,282,18,59,96,136,87,173,260,55,27,32,55,109,488
3439,Seth Gearhart,SR,2014-15,F,Rice,CUSA,32,1084,143,324,74,151,69,173,133,163,36,134,170,58,31,12,71,89,488
3440,Arlon Harper,SO,2012-13,G,Charleston Southern,Big South,32,907,166,359,113,222,53,137,103,138,38,103,141,68,63,4,66,77,488
3441,Terrel Harris,SR,2008-09,G,Oklahoma State,Big 12,35,1110,168,344,111,193,57,151,95,121,29,138,167,67,61,12,65,115,488
3442,Carlik Jones,SO,2018-19,G,Radford,Big South,31,1059,183,395,161,306,22,89,100,132,17,143,160,181,52,2,84,55,488
3443,Louie Krogman,JR,2010-11,G,South Dakota,GWC,33,1043,175,411,97,194,78,217,60,84,15,101,116,76,28,1,37,46,488
3444,Oliver Lafayette,JR,2005-06,G,Houston,CUSA,31,1019,164,451,78,181,86,270,74,108,38,90,128,55,105,4,65,76,488
3445,Scott Machado,JR,2010-11,G,Iona,MAAC,37,1264,167,407,127,282,40,125,114,169,32,111,143,281,49,6,131,89,488
3446,Sean Marshall,SR,2006-07,G,Boston College,ACC,33,1090,181,404,131,264,50,140,76,112,55,93,148,64,37,9,70,63,488
3447,Patrick Miller,JR,2012-13,G,Tennessee State,OVC,33,1186,153,358,111,236,42,122,140,180,37,104,141,190,55,9,113,92,488
3448,Luke Nevill,SO,2006-07,C,Utah,MWC,29,907,181,284,181,284,0,0,126,170,72,151,223,45,13,33,63,76,488
3449,Kezie Okpala,SO,2018-19,F,Stanford,Pac-12,29,949,170,367,138,280,32,87,116,173,34,131,165,58,29,15,83,73,488
3450,Chris Oliver,JR,2005-06,F,Radford,Big South,28,988,189,375,174,329,15,46,95,130,114,165,279,50,41,30,53,63,488
3451,Drake Reed,JR,2007-08,F,Austin Peay,OVC,34,1103,161,352,157,336,4,16,162,228,77,115,192,68,32,16,99,86,488
3452,Isaiah Still,SO,2016-17,G,Robert Morris,NEC,31,1011,152,396,92,212,60,184,124,197,31,113,144,55,28,7,70,65,488
3453,Jayson Tatum,FR,2016-17,F,Duke,ACC,29,966,165,365,125,248,40,117,118,139,39,174,213,62,39,33,76,86,488
3454,Deonta Vaughn,JR,2008-09,G,Cincinnati,Big East,32,1146,155,399,74,159,81,240,97,120,19,108,127,149,43,0,107,82,488
3455,Aaron White,SO,2012-13,F,Iowa,Big Ten,38,1109,140,299,125,233,15,66,193,258,88,146,234,51,41,27,62,54,488
3456,B.J. Young,FR,2011-12,G,Arkansas,SEC,32,807,177,351,127,230,50,121,84,113,29,70,99,73,37,8,74,64,488
3457,Milton Doyle,SR,2016-17,G,Loyola (IL),MVC,32,1044,168,376,127,260,41,116,110,138,19,142,161,142,55,22,92,77,487
3458,Demetrius Dyson,SR,2017-18,G,Samford,Southern,32,985,161,358,81,168,80,190,85,111,34,126,160,35,30,9,68,66,487
3459,Jacob Evans,SO,2016-17,G,Cincinnati,AAC,36,1138,168,355,99,190,69,165,82,112,53,97,150,96,46,30,45,76,487
3460,Al Fisher,JR,2007-08,G,Kent State,MAC,35,1110,164,407,125,281,39,126,120,144,29,105,134,141,44,7,146,78,487
3461,Justin Forrest,SO,2018-19,G,Appalachian State,Sun Belt,30,870,150,369,86,192,64,177,123,170,16,83,99,74,37,0,82,57,487
3462,Roberto Gallinat,SR,2018-19,G,Pacific,WCC,32,886,125,288,67,136,58,152,179,209,17,81,98,18,14,5,50,83,487
3463,Paul George,SO,2009-10,F,Fresno State,WAC,29,962,154,363,95,196,59,167,120,132,55,155,210,88,64,24,94,84,487
3464,Paul George,FR,2008-09,F,Fresno State,WAC,34,1176,166,353,103,212,63,141,92,132,63,149,212,63,59,34,79,92,487
3465,Kevin Giltner,SR,2011-12,G,Wofford,Southern,33,1253,165,416,79,175,86,241,71,90,21,119,140,60,29,8,65,72,487
3466,Dajuan Graf,SR,2016-17,G,North Carolina Central,MEAC,34,1207,176,360,144,279,32,81,103,132,21,97,118,178,40,1,93,67,487
3467,Chad Gray,JR,2009-10,F,Coastal Carolina,Big South,34,800,191,371,174,315,17,56,88,145,76,87,163,23,18,27,64,85,487
3468,Lawrence Hill,SO,2006-07,F,Stanford,Pac-10,31,977,179,352,129,230,50,122,79,113,55,132,187,56,22,33,54,61,487
3469,Jeremy Ingram,JR,2012-13,G,North Carolina Central,MEAC,31,1031,145,331,82,171,63,160,134,168,22,92,114,44,43,18,78,87,487
3470,Alize Johnson,JR,2016-17,F,Missouri State,MVC,33,997,169,346,129,243,40,103,109,161,110,241,351,63,20,6,76,83,487
3471,Arsalan Kazemi,SO,2010-11,F,Rice,CUSA,32,954,146,278,146,278,0,0,195,271,120,231,351,43,38,26,57,85,487
3472,Robo Kreps,SR,2010-11,G,Illinois-Chicago,Horizon,31,1190,166,399,95,202,71,197,84,106,16,115,131,90,42,2,76,51,487
3473,Cody Larson,JR,2014-15,F,South Dakota State,Summit,35,999,172,346,169,337,3,9,140,191,71,181,252,64,22,37,65,102,487
3474,Otis Livingston II,SO,2016-17,G,George Mason,A-10,34,1178,159,384,114,250,45,134,124,135,6,101,107,102,38,0,69,52,487
3475,Dikymbe Martin,JR,2018-19,G,UC-Riverside,Big West,33,1073,177,374,109,220,68,154,65,76,8,86,94,87,27,1,58,60,487
3478,Grant Maxey,SO,2007-08,F,Jackson State,SWAC,33,912,178,365,152,291,26,74,105,142,72,146,218,53,49,25,80,96,487
3479,Sam McDaniel,SR,2017-18,G,Louisiana-Monroe,Sun Belt,32,1074,162,381,86,196,76,185,87,108,38,146,184,66,33,9,70,79,487
3480,LaQuentin Miles,SR,2013-14,G,Central Arkansas,Southland,21,702,175,357,164,322,11,35,126,209,48,109,157,58,29,9,84,42,487
3481,Harouna Mutombo,SR,2011-12,G,Western Carolina,Southern,35,1047,173,406,149,321,24,85,117,191,63,143,206,68,50,11,77,84,487
3482,Steven Pledger,JR,2011-12,G,Oklahoma,Big 12,30,987,170,370,98,197,72,173,75,90,41,76,117,49,30,7,57,73,487
3483,Ricardo Ratliffe,SR,2011-12,F,Missouri,Big 12,35,916,210,303,210,303,0,0,67,97,110,151,261,21,21,35,56,92,487
3484,Scottie Reynolds,FR,2006-07,G,Villanova,Big East,33,978,139,359,75,189,64,170,145,176,12,82,94,133,46,4,102,86,487
3485,Wesley Saunders,SO,2012-13,G,Harvard,Ivy,30,1120,163,311,153,291,10,20,151,207,27,98,125,104,55,11,91,70,487
3486,David Teague,SR,2006-07,G,Purdue,Big Ten,34,1066,177,402,93,198,84,204,49,65,50,119,169,67,24,5,63,66,487
3487,Lorrenzo Wade,JR,2007-08,F,San Diego State,MWC,33,1059,174,387,151,315,23,72,116,173,31,119,150,119,33,20,94,85,487
3488,Anthony Beane,SO,2013-14,G,Southern Illinois,MVC,33,1126,176,374,124,242,52,132,82,107,24,83,107,51,38,4,59,71,486
3489,Trevor Booker,SR,2009-10,F,Clemson,ACC,32,984,188,361,179,327,9,34,101,171,89,179,268,81,43,45,62,63,486
3490,Yonel Brown,JR,2014-15,G,Kennesaw State,A-Sun,32,1184,144,350,81,185,63,165,135,150,14,60,74,89,38,0,80,55,486
3491,Kevin Foster,FR,2008-09,G,Santa Clara,WCC,33,1000,163,396,78,164,85,232,75,96,14,65,79,83,42,6,91,71,486
3492,Jaylen Franklin,FR,2015-16,G,Abilene Christian,Southland,30,883,176,343,168,315,8,28,126,206,23,92,115,82,52,4,85,84,486
3493,Rashaun Freeman,SR,2006-07,C,Massachusetts,A-10,33,897,206,338,206,336,0,2,74,129,122,151,273,27,19,14,73,111,486
3494,Anton Grady,JR,2014-15,F,Cleveland State,Horizon,33,984,191,391,187,381,4,10,100,155,75,186,261,59,49,45,71,102,486
3495,Chase Griffin,SR,2006-07,G,Pepperdine,WCC,31,967,158,365,105,223,53,142,117,145,38,97,135,62,52,1,62,68,486
3496,Eric Griffin,SR,2011-12,F,Campbell,Big South,31,939,177,290,166,260,11,30,121,213,83,185,268,46,29,73,85,100,486
3497,Justin Hare,SR,2007-08,G,Belmont,A-Sun,33,931,156,367,94,202,62,165,112,122,22,75,97,92,32,3,65,36,486
3500,Joey Henley,SR,2008-09,F,Sacred Heart,NEC,31,949,196,313,196,312,0,1,94,146,73,136,209,43,23,40,63,78,486
3501,Darrun Hilliard,JR,2013-14,G,Villanova,Big East,34,991,157,323,87,154,70,169,102,142,30,94,124,90,44,17,76,68,486
3502,Tommy Hubbard,JR,2009-10,G,East Tennessee State,A-Sun,35,1172,182,408,169,361,13,47,109,152,98,188,286,42,58,14,81,123,486
3503,Jarred Jones,SR,2016-17,G,Loyola (MD),Patriot,33,1020,181,397,175,377,6,20,118,160,49,166,215,63,45,36,93,88,486
3504,Maurice Joseph,SR,2009-10,G,Vermont,AEC,35,1021,143,361,66,155,77,206,123,145,20,71,91,39,17,7,53,60,486
3505,Aleksa Jugovic,JR,2016-17,G,Tennessee Tech,OVC,32,1123,148,372,66,144,82,228,108,119,13,69,82,68,25,5,59,50,486
3506,Matthew Knight,JR,2005-06,F,Loyola Marymount,WCC,30,957,191,368,191,366,0,2,104,174,112,187,299,25,33,23,43,60,486
3507,Patrick McCaw,SO,2015-16,G,Nevada-Las Vegas,MWC,33,1113,168,361,100,175,68,186,82,106,38,131,169,128,81,13,68,73,486
3508,Erik McCree,JR,2015-16,F,Louisiana Tech,CUSA,30,955,165,373,117,235,48,138,108,151,39,184,223,38,20,16,74,68,486
3509,Nick McGlynn,SR,2018-19,F,Drake,MVC,32,926,184,341,168,273,16,68,102,135,59,206,265,44,16,53,58,70,486
3510,Malcolm McMillan,SR,2015-16,G,Canisius,MAAC,33,1132,132,313,91,186,41,127,181,218,17,85,102,135,22,17,60,79,486
3511,Tyrell Nelson,SO,2014-15,C,Gardner-Webb,Big South,35,966,195,320,195,318,0,2,96,152,101,128,229,29,22,29,56,107,486
3512,Julysses Nobles,SR,2013-14,G,Jackson State,SWAC,31,1096,153,396,117,275,36,121,144,205,14,116,130,112,44,4,98,79,486
3513,Kyle Ohman,JR,2008-09,G,Liberty,Big South,35,1173,155,365,55,124,100,241,76,99,30,165,195,93,44,13,72,85,486
3514,Evan Payne,SO,2014-15,G,Loyola Marymount,WCC,27,764,160,361,123,256,37,105,129,163,21,55,76,45,21,5,63,42,486
3515,Nick Rakocevic,JR,2018-19,F,Southern California,Pac-12,33,991,190,347,190,343,0,4,106,156,109,199,308,44,28,47,55,106,486
3516,Gerald Robinson,FR,2007-08,G,Tennessee State,OVC,32,943,187,403,127,225,60,178,52,71,27,60,87,41,53,4,55,65,486
3517,Admiral Schofield,JR,2017-18,F,Tennessee,SEC,35,982,177,396,113,234,64,162,68,90,56,168,224,52,34,15,63,102,486
3518,Damon Sherman-Newsome,SR,2014-15,G,Colgate,Patriot,33,1026,175,380,107,198,68,182,68,100,18,93,111,60,20,5,60,51,486
3519,Chris Silva,SR,2018-19,F,South Carolina,SEC,32,853,150,295,127,249,23,46,163,219,85,159,244,30,28,62,73,114,486
3522,Patrick Sullivan,SR,2009-10,C,Southeastern Louisiana,Southland,31,928,194,363,193,358,1,5,97,139,70,199,269,64,30,102,83,92,486
3523,Nic Thomas,JR,2018-19,G,Norfolk State,MEAC,34,1010,137,366,51,148,86,218,126,156,24,87,111,55,27,2,72,85,486
3524,Derrick Williams,FR,2009-10,F,Arizona,Pac-10,31,875,162,282,158,266,4,16,158,232,68,151,219,22,19,20,60,78,486
3525,Sean Baptiste,SR,2009-10,G,Fairleigh Dickinson,NEC,30,1048,167,396,105,224,62,172,89,128,37,131,168,33,26,8,64,81,485
3526,Bruce Beckford,JR,2014-15,F,North Carolina A&T,MEAC,32,1063,167,378,141,281,26,97,125,152,70,163,233,45,28,22,88,85,485
3527,Patrick Beverley,FR,2006-07,G,Arkansas,SEC,35,1203,150,351,77,162,73,189,112,138,39,117,156,110,61,14,70,77,485
3528,Jacobi Boykins,SR,2017-18,G,Louisiana Tech,CUSA,33,1008,145,343,47,95,98,248,97,106,18,142,160,50,33,11,39,73,485
3529,Rodney Bullock,SR,2017-18,F,Providence,Big East,34,1120,164,377,117,236,47,141,110,149,50,148,198,39,27,33,66,85,485
3530,Ricky Cadell,SR,2010-11,G,St. Francis (NY),NEC,30,939,154,398,89,197,65,201,112,143,23,88,111,54,33,0,74,69,485
3531,Ian Chiles,SR,2013-14,C,Morgan State,MEAC,31,882,185,337,185,337,0,0,115,173,77,126,203,28,14,92,48,93,485
3532,DeMar DeRozan,FR,2008-09,F,Southern California,Pac-10,35,1168,192,367,186,331,6,36,95,147,84,117,201,51,31,13,73,73,485
3533,Justin Edwards,SO,2012-13,G,Maine,AEC,29,950,175,400,148,301,27,99,108,158,50,100,150,99,56,12,119,83,485
3534,Tim Hardaway,FR,2010-11,G,Michigan,Big Ten,35,1074,159,379,83,172,76,207,91,119,27,106,133,59,34,5,45,68,485
3535,Mustapha Heron,FR,2016-17,G,Auburn,SEC,32,901,152,344,108,240,44,104,137,178,52,143,195,43,27,6,77,87,485
3536,Carlos Johnson,JR,2018-19,G,Grand Canyon,WAC,34,826,166,339,134,241,32,98,121,155,47,91,138,53,32,5,92,89,485
3537,Melvin Johnson,SR,2013-14,G,Arkansas State,Sun Belt,32,947,156,330,68,146,88,184,85,112,15,126,141,42,27,2,65,62,485
3538,Kris Joseph,JR,2010-11,F,Syracuse,Big East,34,1101,156,342,111,219,45,123,128,180,38,140,178,74,51,22,73,63,485
3539,Cyril Langevine,JR,2018-19,F,Rhode Island,A-10,33,1071,178,314,178,312,0,2,129,215,111,217,328,29,24,46,99,98,485
3540,Maarty Leunen,SR,2007-08,F,Oregon,Pac-10,32,1110,157,281,98,161,59,120,112,142,69,224,293,90,28,11,50,78,485
3541,Scottie Lindsey,SR,2017-18,G,Northwestern,Big Ten,32,1026,169,424,90,206,79,218,68,82,24,99,123,54,15,14,52,82,485
3544,Jordan Loveridge,SO,2013-14,F,Utah,Pac-12,33,1136,163,388,119,244,44,144,115,143,46,184,230,77,25,15,65,59,485
3545,Roman Martinez,SR,2009-10,F,New Mexico,MWC,35,1122,160,365,61,125,99,240,66,88,75,132,207,50,51,19,33,88,485
3546,Stephen Maxwell,SR,2014-15,F,Cal State Northridge,Big West,33,1111,171,350,171,350,0,0,143,194,108,155,263,19,25,5,67,88,485
3547,Eric Maynor,SO,2006-07,G,Virginia Commonwealth,CAA,35,1214,161,380,138,321,23,59,140,180,22,126,148,224,48,7,73,75,485
3548,A.J. Mosby,SR,2017-18,G,Alcorn State,SWAC,32,1030,178,354,120,209,58,145,71,82,14,136,150,124,46,4,64,56,485
3549,Aaric Murray,SO,2010-11,C,La Salle,A-10,32,899,186,384,166,327,20,57,93,123,89,156,245,41,31,72,75,99,485
3550,Earl Potts,SO,2015-16,G,Fairleigh Dickinson,NEC,33,1054,181,360,115,195,66,165,57,79,46,163,209,47,36,10,46,113,485
3551,Cam Reddish,FR,2018-19,F,Duke,ACC,36,1069,154,432,65,165,89,267,88,114,20,113,133,70,56,21,96,86,485
3552,Nick Ward,FR,2016-17,F,Michigan State,Big Ten,35,694,181,306,181,306,0,0,123,200,97,130,227,14,12,54,58,98,485
3553,Charlie Westbrook,JR,2010-11,G,South Dakota,GWC,30,855,187,390,167,320,20,70,91,134,31,110,141,36,34,18,69,74,485
3554,Khalil Ahmad,JR,2017-18,G,Cal State Fullerton,Big West,32,1002,170,407,113,229,57,178,87,105,17,104,121,52,39,7,78,68,484
3555,Chaisson Allen,SR,2010-11,G,Northeastern,CAA,29,1077,156,374,94,211,62,163,110,157,40,136,176,106,61,2,56,56,484
3556,Jarvis Bradley,JR,2006-07,C,McNeese State,Southland,32,1017,187,363,187,362,0,1,110,167,92,143,235,24,28,33,91,103,484
3557,Torrion Brummitt,SR,2015-16,F,Western Carolina,Southern,34,956,184,362,175,318,9,44,107,171,67,184,251,47,31,27,98,128,484
3558,Chase Budinger,FR,2006-07,F,Arizona,Pac-10,31,1024,176,363,126,227,50,136,82,97,56,123,179,62,37,13,49,53,484
3559,Bradford Burgess,SR,2011-12,G,Virginia Commonwealth,CAA,36,1164,142,389,61,168,81,221,119,150,42,138,180,56,39,11,45,81,484
3560,A'uston Calhoun,SR,2012-13,F,Bowling Green State,MAC,32,1090,183,412,162,353,21,59,97,124,74,154,228,25,12,16,71,61,484
3561,Angelo Caloiaro,SR,2011-12,F,San Francisco,WCC,34,1046,147,300,91,157,56,143,134,169,51,152,203,80,56,8,57,66,484
3562,Devin Cannady,JR,2017-18,G,Princeton,Ivy,29,1064,164,363,84,160,80,203,76,86,17,140,157,49,24,2,44,54,484
3563,Donald Copeland,SR,2005-06,G,Seton Hall,Big East,30,1068,147,367,76,186,71,181,119,141,16,75,91,135,41,0,72,59,484
3564,Olek Czyz,SR,2011-12,F,Nevada,WAC,35,994,180,333,164,279,16,54,108,172,76,151,227,32,23,9,85,78,484
3565,Tyler Dorsey,FR,2015-16,G,Oregon,Pac-12,36,1083,153,347,86,182,67,165,111,156,48,107,155,71,29,7,69,76,484
3566,Tyreek Duren,JR,2012-13,G,La Salle,A-10,34,1173,161,354,114,232,47,122,115,148,20,77,97,111,56,13,67,64,484
3567,Shaq Goodwin,SR,2015-16,F,Memphis,AAC,33,976,162,338,159,326,3,12,157,216,77,172,249,49,33,61,65,105,484
3568,Blake Griffin,FR,2007-08,F,Oklahoma,Big 12,33,937,184,324,184,322,0,2,116,197,108,193,301,61,33,28,76,82,484
3569,Justin Hare,SO,2005-06,G,Belmont,A-Sun,31,993,164,343,111,207,53,136,103,132,24,100,124,90,34,3,63,73,484
3570,Connor Hill,JR,2013-14,G,Idaho,WAC,34,1071,164,373,66,131,98,242,58,77,5,82,87,41,24,0,27,66,484
3571,Mathieu Kamba,SR,2017-18,G,Central Arkansas,Southland,35,1059,171,330,142,249,29,81,113,172,70,144,214,80,39,35,80,81,484
3572,Tiwian Kendley,JR,2016-17,G,Morgan State,MEAC,23,744,139,373,91,218,48,155,158,201,42,80,122,29,28,10,99,64,484
3573,Tyrone Kent,SR,2008-09,G,Toledo,MAC,32,1056,168,415,115,236,53,179,95,140,48,117,165,67,42,17,107,79,484
3574,Aurimas Majauskas,JR,2015-16,F,Sam Houston State,Southland,34,811,158,288,141,231,17,57,151,190,62,128,190,54,8,15,51,123,484
3575,Naji Marshall,SO,2018-19,F,Xavier,Big East,33,1186,166,421,118,248,48,173,104,144,29,208,237,112,37,7,108,89,484
3576,James Michael McAdoo,JR,2013-14,F,North Carolina,ACC,34,1023,173,378,173,371,0,7,138,257,90,140,230,59,45,31,48,92,484
3577,Orlando Mendez-Valdez,SR,2008-09,G,Western Kentucky,Sun Belt,34,1138,161,360,60,120,101,240,61,78,44,97,141,140,39,7,72,79,484
3578,Monte Morris,JR,2015-16,G,Iowa State,Big 12,35,1331,188,386,150,280,38,106,70,96,26,112,138,241,62,9,57,55,484
3579,J.D. Paige,SR,2018-19,G,Colorado State,MWC,31,1052,172,376,107,209,65,167,75,93,11,97,108,95,39,7,51,52,484
3580,Justin Ravenel,SR,2018-19,G,Florida A&M,MEAC,31,1093,157,342,53,118,104,224,66,77,10,60,70,39,24,3,41,56,484
3581,Glenn Robinson,SO,2013-14,F,Michigan,Big Ten,37,1194,182,373,149,265,33,108,87,115,54,110,164,44,35,11,46,55,484
3582,Kenny Thomas,SR,2008-09,G,Radford,Big South,33,1102,158,377,79,173,79,204,89,121,29,131,160,71,44,4,88,82,484
3583,Al Thornton,JR,2005-06,G,Florida State,ACC,30,871,171,330,151,288,20,42,122,164,87,121,208,37,29,9,73,75,484
3586,Frank Turner,JR,2008-09,G,Canisius,MAAC,31,1175,180,427,162,363,18,64,106,164,35,102,137,124,36,3,126,68,484
3587,Kwame Vaughn,JR,2011-12,G,Cal State Fullerton,Big West,31,975,157,343,98,192,59,151,111,131,17,124,141,116,28,4,83,77,484
3588,Brett Bailey,SR,2016-17,F,San Diego,WCC,31,1050,155,357,122,262,33,95,140,185,58,157,215,52,23,11,70,83,483
3589,Jermaine Beal,SR,2009-10,G,Vanderbilt,SEC,33,1071,159,360,87,170,72,190,93,116,7,74,81,103,32,3,52,48,483
3590,Bilal Benn,JR,2008-09,F,Niagara,MAAC,35,1203,180,419,140,292,40,127,83,117,125,201,326,93,84,17,102,93,483
3591,Tim Coleman,JR,2015-16,F,NJIT,A-Sun,35,967,165,352,118,238,47,114,106,139,43,219,262,82,51,32,76,109,483
3592,Garret Covington,JR,2015-16,G,Western Illinois,Summit,27,911,159,358,82,176,77,182,88,111,12,99,111,53,23,5,59,47,483
3593,Josh Cunningham,JR,2017-18,F,Dayton,A-10,31,981,186,288,178,254,8,34,103,149,79,182,261,54,16,13,71,96,483
3594,Zach Graham,SR,2010-11,G,Mississippi,SEC,34,1037,164,384,117,242,47,142,108,124,46,107,153,51,27,17,51,48,483
3595,Erick Green,JR,2011-12,G,Virginia Tech,ACC,31,1071,170,388,128,276,42,112,101,122,18,83,101,88,41,4,46,52,483
3596,Jorge Gutierrez,JR,2010-11,G,University of California,Pac-10,33,1104,143,348,107,239,36,109,161,201,20,104,124,148,53,8,100,89,483
3597,Shaquille Harrison,SR,2015-16,G,Tulsa,AAC,32,1033,174,367,166,326,8,41,127,201,33,144,177,132,60,7,67,69,483
3598,Xavier Henry,FR,2009-10,G,Kansas,Big 12,36,990,162,354,93,189,69,165,90,115,43,114,157,53,54,18,69,66,483
3599,Robert Jarvis,JR,2007-08,G,Oral Roberts,Summit,30,888,147,360,62,152,85,208,104,122,7,66,73,61,31,2,60,53,483
3600,Deon Jones,JR,2013-14,G,Monmouth,MAAC,32,973,150,336,123,255,27,81,156,202,69,152,221,43,39,21,88,77,483
3601,Brian Lillis,SR,2007-08,G,Albany (NY),AEC,30,964,177,376,168,342,9,34,120,173,46,134,180,106,48,22,98,95,483
3602,Daryl Macon,JR,2016-17,G,Arkansas,SEC,36,908,141,311,76,143,65,168,136,157,19,76,95,80,41,2,65,65,483
3603,Jermaine Marrow,FR,2016-17,G,Hampton,MEAC,31,961,160,467,118,315,42,152,121,159,25,73,98,94,21,1,103,79,483
3604,Terrell Miller Jr.,SR,2017-18,F,Murray State,OVC,32,979,178,355,108,181,70,174,57,79,34,241,275,50,26,16,59,80,483
3605,Nick Minnerath,SR,2012-13,F,Detroit Mercy,Horizon,33,977,177,383,126,241,51,142,78,99,59,137,196,32,28,14,44,98,483
3608,Daniel Mullings,SO,2012-13,G,New Mexico State,WAC,35,1202,167,355,147,301,20,54,129,170,63,118,181,91,79,16,105,64,483
3609,Menji Mundadi,SR,2009-10,G,Alabama State,SWAC,31,959,150,345,56,111,94,234,89,119,26,94,120,27,31,4,53,41,483
3610,Tony Murphy,SO,2005-06,G,Norfolk State,MEAC,31,1021,170,428,109,241,61,187,82,110,32,78,110,34,32,1,70,32,483
3611,Jake O'Brien,SO,2009-10,F,Boston University,AEC,35,1158,165,416,114,271,51,145,102,132,70,155,225,16,22,42,61,109,483
3612,Trayvon Palmer,SR,2016-17,G,Chicago State,WAC,32,1151,172,379,147,290,25,89,114,158,95,207,302,49,48,20,92,103,483
3613,Anthony Randolph,FR,2007-08,F,Louisiana State,SEC,31,1016,183,394,181,375,2,19,115,166,86,177,263,38,35,70,92,85,483
3614,Marvin Roberts,JR,2009-10,F,Florida International,Sun Belt,31,920,169,405,125,256,44,149,101,149,33,117,150,52,43,18,88,68,483
3615,Joe Rosga,JR,2017-18,G,Denver,Summit,30,1025,155,322,82,156,73,166,100,111,19,105,124,88,22,2,65,50,483
3616,Shay Shine,SR,2011-12,G,High Point,Big South,31,973,157,345,95,189,62,156,107,132,37,130,167,92,36,14,72,79,483
3617,Diamon Simpson,SR,2008-09,F,Saint Mary's (CA),WCC,35,1145,162,321,159,305,3,16,156,267,125,252,377,21,61,57,56,70,483
3618,Kendall Stephens,SR,2017-18,G,Nevada,MWC,37,1020,155,350,29,58,126,292,47,51,15,61,76,21,17,24,28,90,483
3619,Will Walker,JR,2008-09,G,DePaul,Big East,33,1136,180,433,109,240,71,193,52,79,26,60,86,49,55,6,44,57,483
3620,Sherrod Wright,SR,2013-14,G,George Mason,A-10,31,958,162,362,134,274,28,88,131,186,21,79,100,25,26,5,76,67,483
3621,Demetric Bennett,JR,2006-07,G,South Alabama,Sun Belt,31,1011,171,373,90,187,81,186,59,85,42,129,171,70,53,2,64,52,482
3622,Sharaud Curry,SR,2009-10,G,Providence,Big East,31,989,148,364,88,190,60,174,126,144,22,40,62,105,36,1,65,57,482
3623,David DuBois,SR,2008-09,G,Western Illinois,Summit,27,976,200,413,183,373,17,40,65,93,63,95,158,32,35,13,55,87,482
3624,Michael Frazier,SO,2013-14,G,Florida,SEC,39,1188,158,344,40,79,118,265,48,57,22,115,137,43,43,7,46,62,482
3625,James Holmes,SR,2005-06,G,South Florida,Big East,29,1119,171,447,103,249,68,198,72,109,23,66,89,65,53,1,115,81,482
3626,Paris Horne,SO,2008-09,G,St. John's (NY),Big East,33,1142,181,416,120,234,61,182,59,87,50,61,111,71,53,17,68,72,482
3627,A.J. Jackson,SR,2007-08,F,Robert Morris,NEC,34,968,172,404,123,280,49,124,89,112,62,130,192,30,38,27,64,90,482
3630,Shakur Juiston,JR,2017-18,F,Nevada-Las Vegas,MWC,33,1002,218,341,216,339,2,2,44,86,89,240,329,64,30,21,84,93,482
3631,Acie Law,JR,2005-06,G,Texas A&M,Big 12,30,1042,174,388,137,276,37,112,97,127,20,81,101,119,50,1,74,77,482
3632,Clifton Lee,SR,2005-06,F,Northwestern State,Southland,34,905,189,366,154,277,35,89,69,111,61,151,212,60,25,18,60,65,482
3633,Jairus Lyles,SO,2015-16,G,Maryland-Baltimore County,AEC,21,761,170,360,132,249,38,111,104,149,27,89,116,59,53,0,62,59,482
3634,Jermaine Marshall,SR,2013-14,G,Arizona State,Pac-12,32,1013,162,360,80,157,82,203,76,106,11,88,99,45,24,15,48,76,482
3635,Tre'Larenz Nottingham,SR,2018-19,G,Texas State,Sun Belt,34,1069,146,410,59,129,87,281,103,134,14,119,133,70,42,3,77,80,482
3636,Ryan Pearson,JR,2010-11,F,George Mason,CAA,34,1030,163,319,145,274,18,45,138,195,64,165,229,40,32,20,53,88,482
3637,Will Rayman,SO,2017-18,F,Colgate,Patriot,33,1052,160,358,94,200,66,158,96,119,62,159,221,38,34,28,54,83,482
3638,Kahiem Seawright,SR,2008-09,F,Rhode Island,A-10,34,1044,173,345,173,344,0,1,136,195,92,162,254,74,29,34,73,89,482
3639,Tyrone Shelley,FR,2007-08,G,Pepperdine,WCC,32,839,167,414,119,255,48,159,100,131,65,121,186,29,52,17,86,101,482
3640,Justin Strings,SO,2015-16,F,Sacramento State,Big Sky,31,976,174,354,114,202,60,152,74,96,51,158,209,30,20,25,29,86,482
3641,Michael Thompson,JR,2009-10,G,Northwestern,Big Ten,34,1281,151,357,63,143,88,214,92,111,13,50,63,139,36,4,59,95,482
3642,Mychel Thompson,SR,2010-11,F,Pepperdine,WCC,33,1061,167,462,114,286,53,176,95,123,54,140,194,62,36,33,58,64,482
3643,Ryan Woolridge,SO,2017-18,G,North Texas,CUSA,38,1391,190,383,173,329,17,54,85,168,35,162,197,221,52,17,130,80,482
3644,Brock Young,JR,2009-10,G,East Carolina,CUSA,31,1081,146,381,114,266,32,115,158,193,18,95,113,171,48,0,134,77,482
3645,Shaddean Aaron,SR,2007-08,G,Mercer,A-Sun,30,984,168,377,114,225,54,152,91,111,52,85,137,48,40,19,55,69,481
3646,Tavarus Alston,SR,2009-10,G,North Carolina A&T,MEAC,33,997,167,415,117,235,50,180,97,139,15,67,82,128,45,6,92,64,481
3647,Keith Appling,JR,2012-13,G,Michigan State,Big Ten,36,1208,156,376,115,248,41,128,128,171,14,109,123,120,46,20,84,83,481
3648,Askia Booker,JR,2013-14,G,Colorado,Pac-12,35,1069,166,427,129,291,37,136,112,137,20,111,131,116,45,2,88,62,481
3649,Greg Brunner,SR,2005-06,F,Iowa,Big Ten,34,1087,164,361,152,320,12,41,141,203,98,216,314,60,33,20,84,86,481
3652,Anthony Campbell,SO,2009-10,F,Austin Peay,OVC,31,1073,160,329,103,176,57,153,104,129,34,131,165,50,35,8,84,49,481
3653,Matt Carlino,JR,2013-14,G,Brigham Young,WCC,35,954,164,426,104,249,60,177,93,135,19,99,118,151,61,5,70,63,481
3654,Jawan Carter,SO,2008-09,G,Delaware,CAA,32,1095,141,352,79,165,62,187,137,176,24,54,78,83,34,0,79,72,481
3655,Kevin Coble,JR,2008-09,F,Northwestern,Big Ten,31,1060,179,379,132,260,47,119,76,99,22,126,148,76,41,19,43,48,481
3656,Geno Crandall,SO,2016-17,G,North Dakota,Big Sky,31,1006,163,324,125,217,38,107,117,156,24,99,123,136,64,10,102,99,481
3657,Bennet Davis,SR,2006-07,F,Northeastern,CAA,32,1101,174,405,154,357,20,48,113,169,65,146,211,71,28,67,82,77,481
3658,Paul Delaney,JR,2006-07,G,Alabama-Birmingham,CUSA,31,1150,157,342,138,268,19,74,148,209,32,118,150,160,59,10,110,81,481
3659,Jon Diebler,JR,2009-10,G,Ohio State,Big Ten,37,1376,148,338,32,62,116,276,69,79,9,93,102,54,42,3,38,65,481
3660,Dion Dixon,SR,2011-12,G,Cincinnati,Big East,37,1266,159,429,112,249,47,180,116,166,67,59,126,76,60,17,67,45,481
3661,Frank Eaves,JR,2014-15,G,Appalachian State,Sun Belt,29,959,138,361,76,184,62,177,143,176,33,80,113,49,38,0,73,63,481
3662,D.J. Fenner,SR,2016-17,G,Nevada,MWC,35,1052,156,346,92,199,64,147,105,126,34,93,127,58,20,12,63,102,481
3663,Reginald Gee,SO,2017-18,G,Alabama State,SWAC,31,931,152,349,92,201,60,148,117,151,39,105,144,30,20,14,48,63,481
3664,Drew Gordon,SR,2011-12,F,New Mexico,MWC,35,1078,188,347,186,345,2,2,103,137,108,280,388,43,39,35,82,78,481
3665,Devonte' Graham,JR,2016-17,G,Kansas,Big 12,36,1269,157,367,63,125,94,242,73,92,17,95,112,149,55,7,64,56,481
3666,Kyle Guy,SO,2017-18,G,Virginia,ACC,34,1102,178,429,95,217,83,212,42,51,13,76,89,50,35,1,42,41,481
3667,Tyrone Hamilton,JR,2007-08,G,Centenary (LA),Summit,30,,153,392,67,174,86,218,89,120,,,101,81,37,1,112,,481
3668,Chris Hansen,JR,2013-14,G,Idaho State,Big Sky,29,1001,150,352,70,152,80,200,101,131,16,97,113,54,31,5,53,60,481
3669,D'Angelo Harrison,SO,2012-13,G,St. John's (NY),Big East,27,945,155,393,97,209,58,184,113,147,29,87,116,61,37,8,59,71,481
3670,Troy Huff,JR,2012-13,G,North Dakota,Big Sky,25,804,174,388,137,284,37,104,96,145,59,114,173,30,59,7,56,38,481
3671,Matt Klinewski,JR,2016-17,F,Lafayette,Patriot,30,825,195,380,195,378,0,2,91,118,48,131,179,36,14,16,76,80,481
3672,Corey Lowe,SR,2009-10,G,Boston University,AEC,32,1068,159,424,84,204,75,220,88,134,31,112,143,136,40,13,134,80,481
3673,Makai Mason,SO,2015-16,G,Yale,Ivy,30,981,161,377,106,223,55,154,104,129,15,68,83,115,25,2,91,55,481
3674,Leonard Mendez,JR,2007-08,G,Georgia State,CAA,30,1031,173,399,103,226,70,173,65,94,27,80,107,39,38,4,59,38,481
3675,Eddie Miller,SR,2007-08,G,Fresno State,WAC,32,1112,156,380,43,101,113,279,56,70,17,77,94,33,31,15,39,37,481
3676,Xavier Moon,SR,2016-17,G,Morehead State,OVC,30,1051,164,378,93,205,71,173,82,92,12,94,106,139,35,9,59,58,481
3677,Tayler Persons,JR,2017-18,G,Ball State,MAC,32,953,187,406,149,304,38,102,69,103,17,90,107,137,26,5,94,78,481
3678,Neal Pitt,FR,2008-09,F,Maryland-Eastern Shore,MEAC,30,975,173,370,155,308,18,62,117,194,99,144,243,28,25,11,90,95,481
3679,Leslie Robinson,SR,2007-08,G,Florida A&M,MEAC,32,,159,382,56,118,103,264,60,72,20,83,103,37,36,4,65,60,481
3680,Avery Smith,JR,2006-07,G,Milwaukee,Horizon,31,883,178,409,142,302,36,107,89,115,41,78,119,83,36,12,72,83,481
3681,Delvin Thompson,JR,2005-06,G,Alcorn State,SWAC,28,923,160,372,120,235,40,137,121,180,29,93,122,65,48,3,111,74,481
3682,Phil Valenti,JR,2015-16,F,Canisius,MAAC,33,1036,170,366,123,245,47,121,94,122,60,141,201,65,31,15,51,89,481
3683,Colton Weisbrod,SR,2017-18,F,Lamar,Southland,33,1124,171,371,153,327,18,44,121,182,95,171,266,61,37,6,66,81,481
3684,Jordan Woodard,JR,2015-16,G,Oklahoma,Big 12,37,1102,151,363,71,187,80,176,99,123,33,78,111,124,59,7,60,89,481
3685,Dominic Artis,SR,2016-17,G,Texas-El Paso,CUSA,32,1168,175,400,138,274,37,126,93,146,18,189,207,187,60,4,99,75,480
3686,DaQuan Bracey,JR,2018-19,G,Louisiana Tech,CUSA,31,964,174,408,127,257,47,151,85,135,28,70,98,124,40,4,67,63,480
3687,Darien Brothers,SR,2012-13,G,Richmond,A-10,34,994,143,348,59,152,84,196,110,126,16,65,81,41,33,6,44,67,480
3688,Matthew Butler,JR,2016-17,G,Tennessee-Martin,OVC,35,1253,172,415,90,196,82,219,54,76,9,92,101,129,21,1,110,84,480
3689,Keith Clanton,JR,2011-12,F,Central Florida,CUSA,33,1085,176,382,137,266,39,116,89,152,98,168,266,61,34,59,79,92,480
3690,Denis Clemente,JR,2008-09,G,Kansas State,Big 12,32,952,167,412,108,251,59,161,87,109,19,59,78,112,27,0,84,76,480
3691,D.J. Cooper,SR,2012-13,G,Ohio,MAC,34,1075,150,354,74,145,76,209,104,148,15,94,109,242,68,6,119,53,480
3694,Nicchaeus Doaks,SR,2008-09,F,Chattanooga,Southern,35,1021,162,317,145,257,17,60,139,221,92,210,302,49,24,35,87,95,480
3695,Mike Efevberha,JR,2005-06,G,Cal State Northridge,Big West,28,772,153,391,96,232,57,159,117,142,25,67,92,57,33,14,87,72,480
3696,Alonzo Gee,SR,2008-09,F,Alabama,SEC,32,1027,176,398,149,324,27,74,101,161,91,140,231,41,29,21,73,61,480
3697,Alonzo Gee,JR,2007-08,F,Alabama,SEC,33,994,169,403,133,287,36,116,106,156,94,130,224,44,51,13,63,77,480
3698,Darrion Griffin,JR,2007-08,G,Jackson State,SWAC,34,946,155,318,126,246,29,72,141,206,51,77,128,80,23,4,81,76,480
3699,Kevon Harris,SO,2017-18,G,Stephen F. Austin,Southland,33,863,159,331,101,195,58,136,104,153,70,112,182,43,34,7,60,54,480
3700,Desmond Holloway,JR,2010-11,G,Coastal Carolina,Big South,26,832,162,323,138,255,24,68,132,173,42,138,180,45,34,9,63,57,480
3701,Tramaine Isabell,SR,2018-19,G,Saint Louis,A-10,35,1139,164,399,110,233,54,166,98,138,37,106,143,127,41,3,104,61,480
3702,Cory Johnson,SR,2010-11,F,Valparaiso,Horizon,34,894,182,374,163,288,19,86,97,137,57,91,148,50,17,17,80,110,480
3703,Antoine Jordan,SR,2005-06,G,Siena,MAAC,28,1019,167,356,133,281,34,75,112,137,51,177,228,83,43,16,63,70,480
3704,Dale Lamberth,SR,2007-08,F,Missouri State,MVC,33,956,176,363,118,218,58,145,70,86,72,102,174,33,18,0,34,58,480
3705,Anthony Livingston,JR,2015-16,F,Arkansas State,Sun Belt,31,961,168,390,146,306,22,84,122,142,80,210,290,15,19,25,54,90,480
3706,Sammy Mejia,SR,2006-07,G,DePaul,Big East,34,1140,188,391,146,272,42,119,62,103,74,128,202,89,35,4,65,72,480
3707,Jaysean Paige,SR,2015-16,G,West Virginia,Big 12,35,786,171,376,128,243,43,133,95,121,55,68,123,43,53,8,54,100,480
3708,Rod Rucker,JR,2012-13,F,Alabama-Birmingham,CUSA,33,1091,204,425,204,418,0,7,72,125,101,169,270,75,37,24,86,92,480
3709,Josh Shipp,SR,2008-09,F,UCLA,Pac-10,33,962,170,337,115,210,55,127,85,106,24,77,101,51,43,12,60,54,480
3710,Shamari Spears,JR,2009-10,F,Charlotte,A-10,30,862,176,379,169,357,7,22,121,158,73,105,178,22,24,9,59,68,480
3711,Jamaal Tatum,JR,2005-06,G,Southern Illinois,MVC,32,1059,163,446,116,285,47,161,107,137,24,58,82,104,42,3,85,67,480
3712,Seth Towns,SO,2017-18,F,Harvard,Ivy,30,838,161,384,98,241,63,143,95,118,32,138,170,54,25,19,64,74,480
3713,Reggie Upshaw,JR,2015-16,F,Middle Tennessee,CUSA,35,1091,185,372,158,301,27,71,83,168,103,195,298,76,51,29,64,81,480
3716,Kwadzo Ahelegbe,SR,2010-11,G,Northern Iowa,MVC,34,1067,151,359,110,231,41,128,136,173,16,92,108,102,19,5,72,70,479
3717,Alec Brown,JR,2012-13,F,Green Bay,Horizon,34,1042,170,379,140,309,30,70,109,146,67,137,204,42,20,59,90,100,479
3718,Derrick Brown,JR,2008-09,F,Xavier,A-10,35,1033,170,337,131,247,39,90,100,135,82,130,212,68,25,30,61,87,479
3719,Da'Sean Butler,SO,2007-08,F,West Virginia,Big East,37,1133,186,376,152,283,34,93,73,114,86,142,228,64,26,7,57,101,479
3720,Khadeen Carrington,SO,2015-16,G,Seton Hall,Big East,34,1049,163,390,107,223,56,167,97,129,15,92,107,84,40,4,68,60,479
3721,Tweety Carter,SR,2009-10,G,Baylor,Big 12,32,1161,161,369,82,164,79,205,78,99,11,77,88,188,42,0,80,59,479
3722,Brett Comer,JR,2013-14,G,Florida Gulf Coast,A-Sun,35,1084,177,389,139,282,38,107,87,137,23,79,102,187,41,7,108,84,479
3723,Trevor Cooney,SR,2015-16,G,Syracuse,ACC,37,1347,150,431,58,171,92,260,87,108,22,73,95,82,61,5,56,49,479
3724,Jordon Crawford,SR,2012-13,G,Bowling Green State,MAC,32,1117,180,459,126,289,54,170,65,86,19,63,82,139,55,0,116,71,479
3725,Stacy Davis,SR,2015-16,F,Pepperdine,WCC,32,1093,159,353,128,260,31,93,130,174,83,209,292,64,18,19,72,80,479
3726,Phil Forte,JR,2014-15,G,Oklahoma State,Big 12,32,1078,139,328,69,144,70,184,131,156,3,64,67,55,60,2,60,44,479
3727,Zam Fredrick,SR,2008-09,G,South Carolina,SEC,31,997,165,417,104,255,61,162,88,130,30,53,83,57,26,2,80,73,479
3728,Kentrell Gransberry,SR,2007-08,C,South Florida,Big East,30,953,183,353,183,353,0,0,113,220,109,216,325,46,18,43,69,85,479
3729,Malik Hairston,SO,2005-06,G,Oregon,Pac-10,32,1056,175,372,128,248,47,124,82,119,79,72,151,69,15,20,70,73,479
3730,Eugene Harvey,FR,2006-07,G,Seton Hall,Big East,29,1028,166,357,154,318,12,39,135,161,46,48,94,123,50,0,91,73,479
3731,Josh Hawkinson,SR,2016-17,F,Washington State,Pac-12,31,1097,173,326,145,257,28,69,105,126,56,259,315,79,19,25,53,73,479
3732,John Henson,JR,2011-12,F,North Carolina,ACC,35,1019,205,410,205,410,0,0,69,135,89,259,348,44,20,101,45,55,479
3733,Jeromie Hill,SR,2014-15,F,Texas-San Antonio,CUSA,30,1006,183,433,127,277,56,156,57,93,73,171,244,40,33,20,73,75,479
3734,Brian Laing,JR,2006-07,G,Seton Hall,Big East,29,1052,186,402,165,336,21,66,86,113,66,128,194,60,48,14,59,76,479
3735,Jai Lewis,SR,2005-06,F,George Mason,CAA,35,1065,182,348,166,302,16,46,99,152,101,173,274,64,49,23,71,100,479
3738,Marshall Moses,SR,2010-11,F,Oklahoma State,Big 12,34,1007,182,327,180,323,2,4,113,155,95,153,248,34,19,15,75,107,479
3739,Zane Najdawi,JR,2017-18,F,Citadel,Southern,31,781,172,335,128,227,44,108,91,128,37,118,155,30,21,42,79,69,479
3740,Maurice Ndour,SR,2014-15,F,Ohio,MAC,30,1047,164,339,137,277,27,62,124,158,68,182,250,50,33,68,89,83,479
3741,Joakim Noah,JR,2006-07,C,Florida,SEC,40,1034,173,285,172,284,1,1,132,199,102,235,337,90,45,72,100,90,479
3742,Josh Nzeakor,SR,2018-19,F,Lamar,Southland,32,992,186,301,186,301,0,0,107,183,102,149,251,23,20,15,69,77,479
3743,Braxton Ogbueze,JR,2015-16,G,Charlotte,CUSA,33,1131,160,383,51,128,109,255,50,66,18,58,76,87,16,2,38,51,479
3744,Andre Owens,SR,2005-06,G,Texas-San Antonio,Southland,27,845,182,377,149,276,33,101,82,127,57,105,162,94,45,12,109,82,479
3745,JayVaughn Pinkston,JR,2013-14,F,Villanova,Big East,34,921,160,307,152,276,8,31,151,203,74,134,208,49,31,19,58,83,479
3746,"Ed Polite, Jr.",JR,2017-18,F,Radford,Big South,36,1154,166,350,144,270,22,80,125,172,81,202,283,53,68,34,67,83,479
3747,Joe Reitz,SR,2007-08,C,Western Michigan,MAC,32,925,146,257,145,256,1,1,186,260,93,161,254,28,10,3,76,104,479
3748,Joe Reitz,SO,2005-06,C,Western Michigan,MAC,31,923,162,306,162,305,0,1,155,211,91,139,230,20,15,5,63,107,479
3749,Brandon Riley,SR,2011-12,G,South Carolina State,MEAC,28,915,176,437,125,280,51,157,76,99,26,79,105,48,28,3,91,60,479
3750,Damian Saunders,JR,2009-10,F,Duquesne,A-10,32,1174,193,390,175,295,18,95,75,155,143,217,360,78,89,94,97,80,479
3751,Ryan Thompson,SO,2007-08,G,Rider,MAAC,32,1086,169,315,134,235,35,80,106,142,69,129,198,110,53,19,81,89,479
3752,Josh White,JR,2009-10,G,North Texas,Sun Belt,33,1182,135,325,78,178,57,147,152,185,18,44,62,116,19,2,103,46,479
3753,Alan Williams,SO,2012-13,C,UC-Santa Barbara,Big West,28,793,174,371,174,371,0,0,131,181,114,186,300,24,29,64,66,90,479
3754,Ken Williams,JR,2015-16,G,South Alabama,Sun Belt,31,963,153,418,92,223,61,195,112,140,18,86,104,106,26,6,82,36,479
3755,Tracey Worley,SR,2008-09,G,New Orleans,Sun Belt,30,1011,163,376,116,228,47,148,106,138,23,85,108,38,30,2,75,45,479
3756,Courtney Beasley,SR,2008-09,G,Southern Mississippi,CUSA,32,1113,185,407,175,381,10,26,98,129,71,156,227,49,30,5,39,78,478
3757,Evan Boudreaux,FR,2015-16,F,Dartmouth,Ivy,27,868,155,341,127,272,28,69,140,169,64,190,254,31,22,7,70,72,478
3760,Ramel Bradley,SR,2007-08,G,Kentucky,SEC,30,1052,139,330,81,177,58,153,142,171,17,109,126,101,48,6,100,81,478
3761,Taylor Braun,SO,2011-12,G,North Dakota State,Summit,31,939,158,304,122,224,36,80,126,163,28,178,206,78,39,2,77,77,478
3762,Stephon Carter,SR,2012-13,G,Cal State Bakersfield,Ind,30,954,169,352,167,336,2,16,138,194,42,113,155,81,68,8,92,77,478
3763,Jeremy Chappell,JR,2007-08,G,Robert Morris,NEC,32,1033,190,382,128,207,62,175,36,49,48,105,153,76,80,15,60,81,478
3764,Patrick Christopher,JR,2008-09,G,University of California,Pac-10,33,1100,176,399,128,265,48,134,78,94,41,86,127,68,26,5,55,71,478
3765,Ryan Cook,SR,2012-13,G,Maryland-Baltimore County,AEC,31,987,166,363,119,241,47,122,99,118,68,122,190,59,34,10,80,89,478
3766,Tyler Cook,JR,2018-19,F,Iowa,Big Ten,33,1016,174,341,174,335,0,6,130,202,71,181,252,80,24,18,92,77,478
3767,Quenton DeCosey,SO,2013-14,G,Temple,AAC,31,1128,174,420,116,247,58,173,72,109,24,96,120,73,32,7,55,56,478
3768,Aaseem Dixon,SR,2014-15,G,Northern Arizona,Big Sky,37,1293,158,435,70,207,88,228,74,95,28,98,126,85,27,1,55,63,478
3769,Milton Doyle,FR,2013-14,G,Loyola (IL),MVC,32,1050,154,363,114,236,40,127,130,186,29,104,133,115,38,23,108,88,478
3770,Billy Garrett,SR,2016-17,G,DePaul,Big East,32,938,140,361,99,248,41,113,157,178,12,80,92,107,37,5,105,81,478
3771,Chris Gaston,JR,2011-12,F,Fordham,A-10,28,950,188,426,185,418,3,8,99,152,111,165,276,30,35,46,75,68,478
3772,Jeremy Goode,SO,2007-08,G,Mount St. Mary's,NEC,33,1095,140,321,120,254,20,67,178,256,28,79,107,182,65,0,110,51,478
3773,Kenny Hayes,SR,2009-10,G,Miami (OH),MAC,32,1143,167,369,125,251,42,118,102,128,15,79,94,99,27,5,79,67,478
3774,Joe Jackson,SR,2013-14,G,Memphis,AAC,34,1129,154,348,131,264,23,84,147,190,36,86,122,154,52,2,73,68,478
3775,Johnathon Jones,JR,2008-09,G,Oakland,Summit,36,1361,167,401,134,302,33,99,111,144,21,80,101,290,49,8,124,72,478
3776,Justin Kier,JR,2018-19,G,George Mason,A-10,33,1148,171,363,138,274,33,89,103,134,15,200,215,85,52,10,89,65,478
3777,Kyle Kuric,SR,2011-12,G,Louisville,Big East,38,1369,165,391,89,160,76,231,72,91,45,114,159,45,47,19,38,81,478
3778,Damion Lee,SR,2015-16,G,Louisville,ACC,30,1007,152,355,91,176,61,179,113,134,19,98,117,59,46,1,50,62,478
3779,Kurk Lee,FR,2016-17,G,Drexel,CAA,32,1053,171,412,113,267,58,145,78,115,24,100,124,160,51,0,94,86,478
3780,Caris LeVert,SO,2013-14,G,Michigan,Big Ten,37,1258,163,371,103,224,60,147,92,120,19,141,160,109,44,10,62,63,478
3781,Mark McAndrew,SR,2007-08,G,Brown,Ivy,29,966,140,297,74,141,66,156,132,160,22,124,146,63,38,1,78,64,478
3782,Jordan Mickey,SO,2014-15,F,Louisiana State,SEC,31,1081,191,379,190,370,1,9,95,147,99,209,308,40,29,112,101,81,478
3783,Patrick Mills,SO,2008-09,G,Saint Mary's (CA),WCC,26,867,163,405,96,207,67,198,85,99,12,50,62,101,57,6,75,43,478
3784,Shabazz Napier,JR,2012-13,G,Connecticut,Big East,28,1043,146,331,78,160,68,171,118,144,14,109,123,129,56,3,67,58,478
3785,Saah Nimley,SO,2012-13,G,Charleston Southern,Big South,30,997,151,415,74,180,77,235,99,131,31,128,159,151,39,2,84,65,478
3786,Marshawn Powell,FR,2009-10,F,Arkansas,SEC,32,992,190,380,182,343,8,37,90,142,74,141,215,45,32,42,66,87,478
3787,A.J. Price,JR,2007-08,G,Connecticut,Big East,33,1060,160,366,108,225,52,141,106,142,25,92,117,192,43,3,78,53,478
3788,Brian Qvale,SR,2010-11,C,Montana,Big Sky,32,990,189,302,189,302,0,0,100,155,98,183,281,22,21,95,65,96,478
3789,Quincy Roberts,JR,2011-12,G,Grambling,SWAC,20,746,149,363,110,241,39,122,141,176,24,95,119,32,20,5,75,40,478
3790,Shavon Shields,JR,2014-15,G,Nebraska,Big Ten,31,1095,161,366,144,279,17,87,139,168,45,141,186,67,33,5,84,73,478
3791,Kammron Taylor,SR,2006-07,G,Wisconsin,Big Ten,36,1182,143,340,75,163,68,177,124,157,16,65,81,70,18,2,61,23,478
3792,Tristan Thompson,JR,2009-10,G,North Texas,Sun Belt,33,998,142,330,81,179,61,151,133,162,24,85,109,56,25,2,60,69,478
3793,Romeo Travis,SR,2006-07,F,Akron,MAC,32,904,180,344,177,336,3,8,115,171,78,111,189,53,33,65,61,90,478
3794,Zavier Turner,JR,2016-17,G,Manhattan,MAAC,32,914,133,340,75,196,58,144,154,174,19,54,73,105,32,1,97,92,478
3795,Seth Tuttle,JR,2013-14,F,Northern Iowa,MVC,31,916,156,300,147,262,9,38,157,203,72,177,249,72,30,34,65,76,478
3796,Quinndary Weatherspoon,SO,2016-17,G,Mississippi State,SEC,29,926,173,369,126,243,47,126,85,111,40,108,148,53,50,8,64,68,478
3797,Tai Wesley,JR,2009-10,F,Utah State,WAC,35,963,191,333,191,331,0,2,96,137,100,132,232,117,20,46,63,102,478
3798,Joe Zeglinski,JR,2009-10,G,Hartford,AEC,29,1092,166,445,68,160,98,285,48,65,26,123,149,48,28,6,51,76,478
3799,Karon Abraham,FR,2009-10,G,Robert Morris,NEC,35,938,133,309,48,117,85,192,126,148,22,54,76,53,24,4,63,79,477
3802,Ryan Anderson,SO,2012-13,F,Boston College,ACC,32,1012,182,382,179,368,3,14,110,177,85,170,255,50,21,16,62,53,477
3803,Reid Augst,SR,2008-09,G,North Carolina-Asheville,Big South,31,1075,170,362,139,260,31,102,106,152,56,92,148,79,49,8,78,59,477
3804,Xavier Bishop,JR,2018-19,G,Missouri-Kansas City,WAC,31,1049,161,377,100,204,61,173,94,118,17,68,85,118,35,0,88,77,477
3805,Brandon Bush,SR,2008-09,G,Texas State,Southland,30,870,171,327,156,271,15,56,120,172,62,152,214,65,25,6,82,89,477
3806,Ty Cockfield,JR,2017-18,G,Arkansas State,Sun Belt,32,955,170,384,116,235,54,149,83,106,25,66,91,65,30,4,69,61,477
3807,Darren Collison,JR,2007-08,G,UCLA,Pac-10,33,1144,161,335,108,234,53,101,102,117,17,69,86,124,61,3,74,44,477
3808,Joe Crawford,JR,2006-07,G,Kentucky,SEC,34,1097,178,401,115,221,63,180,58,91,50,87,137,83,27,10,64,65,477
3809,Darrell Davis,SR,2017-18,G,Dayton,A-10,31,1088,150,345,78,156,72,189,105,120,15,111,126,85,21,3,84,69,477
3810,Steven Davis,SR,2016-17,F,Wright State,Horizon,32,901,169,342,117,206,52,136,87,113,54,85,139,32,16,14,66,94,477
3811,Robert Dozier,SR,2008-09,F,Memphis,CUSA,37,1118,166,320,145,264,21,56,124,172,106,171,277,53,47,61,74,101,477
3812,Eric Fanning,SR,2016-17,G,Boston University,Patriot,32,897,139,335,103,233,36,102,163,208,42,151,193,67,27,13,99,81,477
3813,Quincy Ford,SR,2015-16,F,Northeastern,CAA,29,1008,158,386,93,199,65,187,96,129,45,157,202,75,43,25,63,62,477
3814,Shan Foster,SO,2005-06,G,Vanderbilt,SEC,30,967,162,359,72,142,90,217,63,83,25,64,89,48,14,6,47,38,477
3815,Alex Franklin,JR,2008-09,F,Siena,MAAC,35,1126,171,304,171,304,0,0,135,218,96,166,262,30,44,24,79,101,477
3816,Melvin Frazier,JR,2017-18,G,Tulane,AAC,30,1032,179,322,144,231,35,91,84,118,35,133,168,86,65,22,77,60,477
3817,Davante Gardner,SR,2013-14,F,Marquette,Big East,32,850,159,301,157,285,2,16,157,201,69,113,182,43,10,15,36,65,477
3818,C.J. Harris,SR,2012-13,G,Wake Forest,ACC,31,1017,140,310,81,173,59,137,138,163,9,63,72,59,24,3,77,64,477
3819,Roy Hibbert,JR,2006-07,C,Georgetown,Big East,37,975,186,277,186,277,0,0,105,153,100,154,254,39,18,90,46,103,477
3820,Isaiah Johnson,JR,2015-16,C,Akron,MAC,35,889,174,303,173,298,1,5,128,214,93,173,266,57,16,45,54,83,477
3821,Johnathan Jordan,JR,2013-14,G,Texas A&M-Corpus Christi,Southland,33,1119,141,323,133,288,8,35,187,271,33,115,148,177,49,4,88,80,477
3824,Trey Kell,SO,2015-16,G,San Diego State,MWC,38,1084,158,390,87,205,71,185,90,135,29,113,142,54,30,7,67,51,477
3825,Lawrence Kinnard,SR,2008-09,F,Alabama-Birmingham,CUSA,34,1149,185,414,140,267,45,147,62,103,85,227,312,42,37,21,47,78,477
3826,Tanner Leissner,SO,2015-16,F,New Hampshire,AEC,30,984,170,389,148,312,22,77,115,153,75,143,218,46,11,5,65,73,477
3827,Evan Leonard,SO,2017-18,G,UC-Irvine,Big West,35,981,161,360,94,191,67,169,88,111,16,98,114,69,48,4,60,98,477
3828,Kevin Lisch,SO,2006-07,G,Saint Louis,A-10,32,1081,140,327,73,163,67,164,130,158,14,100,114,111,32,12,59,68,477
3829,Corey Lyons,SR,2008-09,G,Norfolk State,MEAC,31,1021,145,382,82,199,63,183,124,167,30,79,109,26,36,17,67,76,477
3830,Z Mason,JR,2012-13,F,Chattanooga,Southern,32,873,173,353,149,277,24,76,107,149,78,165,243,22,29,29,52,56,477
3831,Spencer Parker,SR,2015-16,F,Bowling Green State,MAC,34,986,164,355,131,277,33,78,116,162,51,124,175,58,16,14,80,73,477
3832,Nijal Pearson,FR,2016-17,G,Texas State,Sun Belt,36,1182,167,382,130,275,37,107,106,147,67,139,206,88,49,13,79,84,477
3833,Gyno Pomare,SO,2006-07,C,San Diego,WCC,32,901,182,338,182,338,0,0,113,154,101,164,265,21,20,42,55,73,477
3834,Tajuan Porter,JR,2008-09,G,Oregon,Pac-10,31,1001,148,377,62,149,86,228,95,109,21,55,76,55,32,2,77,64,477
3835,Landry Shamet,SO,2017-18,G,Wichita State,AAC,32,1015,154,315,70,125,84,190,85,103,14,89,103,166,23,6,67,61,477
3836,Chase Simon,SR,2011-12,G,Detroit Mercy,Horizon,36,1209,155,419,106,261,49,158,118,154,56,101,157,87,41,6,96,97,477
3837,Chase Simon,SO,2009-10,G,Detroit Mercy,Horizon,34,1051,170,423,121,277,49,146,88,138,43,130,173,84,41,6,108,77,477
3838,Ben Simons,JR,2011-12,F,Drake,MVC,29,1041,169,359,92,178,77,181,62,73,18,81,99,40,24,9,47,56,477
3839,Bryan Smithson,SR,2007-08,G,North Carolina-Asheville,Big South,29,1049,157,349,95,198,62,151,101,121,20,95,115,120,54,4,70,50,477
3840,Kirk Van Slyke,SR,2013-14,F,Arkansas State,Sun Belt,32,987,162,313,124,220,38,93,115,141,63,125,188,33,24,38,53,83,477
3841,Dez Wells,JR,2013-14,G,Maryland,ACC,32,980,154,320,137,264,17,56,152,186,33,105,138,69,34,27,79,74,477
3842,James Woodard,SR,2015-16,G,Tulsa,AAC,31,1056,145,349,68,134,77,215,110,140,20,143,163,74,31,12,56,49,477
3843,Josh Young,SO,2007-08,G,Drake,MVC,30,957,147,321,61,123,86,198,97,127,14,61,75,53,42,2,50,52,477
3846,Zach Auguste,JR,2014-15,F,Notre Dame,ACC,37,904,190,307,190,307,0,0,96,151,82,157,239,29,25,25,61,94,476
3847,Travis Betran,SR,2013-14,G,Austin Peay,OVC,30,998,147,375,72,163,75,212,107,122,4,39,43,68,22,3,75,34,476
3848,Kenny Boynton,FR,2009-10,G,Florida,SEC,34,1117,165,439,93,194,72,245,74,99,37,50,87,92,37,6,68,53,476
3849,Malcolm Brogdon,JR,2014-15,G,Virginia,ACC,34,1105,158,374,114,246,44,128,116,132,16,118,134,81,24,14,58,65,476
3850,Jalen Cannon,JR,2013-14,F,St. Francis (NY),NEC,32,959,164,335,151,287,13,48,135,189,94,169,263,39,20,17,37,57,476
3851,Brayden Carlson,SR,2013-14,G,South Dakota State,Summit,32,1177,144,318,92,174,52,144,136,174,11,100,111,93,48,3,80,71,476
3852,Osiris Eldridge,JR,2008-09,G,Illinois State,MVC,34,1184,165,408,93,204,72,204,74,106,51,159,210,83,52,14,71,66,476
3853,Keenan Evans,JR,2016-17,G,Texas Tech,Big 12,31,943,159,343,108,225,51,118,107,126,23,64,87,94,31,6,52,64,476
3854,Marquis Gilstrap,SR,2009-10,F,Iowa State,Big 12,32,1029,162,372,119,258,43,114,109,163,88,210,298,45,29,30,87,74,476
3855,Jimmy Hall,SO,2014-15,F,Kent State,MAC,30,859,193,363,191,358,2,5,88,129,89,142,231,46,15,29,68,96,476
3856,Jahlil Jenkins,SO,2018-19,G,Fairleigh Dickinson,NEC,35,1291,161,376,118,245,43,131,111,126,7,100,107,157,57,3,75,52,476
3857,Diego Kapelan,SR,2010-11,G,McNeese State,Southland,32,931,149,381,63,142,86,239,92,104,22,56,78,36,22,2,59,51,476
3858,Michael Kidd-Gilchrist,FR,2011-12,F,Kentucky,SEC,40,1245,160,326,147,275,13,51,143,192,103,194,297,75,39,37,87,97,476
3859,Kyle Kuzma,JR,2016-17,F,Utah,Pac-12,29,894,182,361,155,277,27,84,85,127,81,190,271,71,18,14,62,46,476
3860,Travis Leslie,JR,2010-11,G,Georgia,SEC,33,1062,177,360,164,317,13,43,109,136,106,131,237,97,40,20,71,63,476
3861,Jeremy Lin,SR,2009-10,G,Harvard,Ivy,29,933,149,287,119,199,30,88,148,196,24,103,127,131,71,31,90,85,476
3862,Marcus LoVett,FR,2016-17,G,St. John's (NY),Big East,30,948,166,358,116,227,50,131,94,117,18,70,88,113,40,1,79,61,476
3863,Kelvin Martin,SR,2011-12,F,Charleston Southern,Big South,31,1016,187,318,185,310,2,8,100,166,82,199,281,52,65,51,70,80,476
3864,Ronnie Moss,SO,2009-10,G,Texas Christian,MWC,32,1072,165,408,103,243,62,165,84,123,18,84,102,189,24,7,120,74,476
3865,Ahmad Nivins,JR,2007-08,F,Saint Joseph's,A-10,33,1112,165,255,165,255,0,0,146,197,73,120,193,16,22,39,76,93,476
3868,Prentiss Nixon,SO,2016-17,G,Colorado State,MWC,36,1153,152,400,97,225,55,175,117,144,11,91,102,72,30,4,60,93,476
3869,Javion Ogunyemi,SR,2016-17,F,Siena,MAAC,34,1091,176,329,171,309,5,20,119,189,91,103,194,42,21,65,66,109,476
3870,Eli Pemberton,SO,2017-18,G,Hofstra,CAA,30,1046,145,321,91,189,54,132,132,175,48,96,144,67,20,5,61,75,476
3871,Xavier Rathan-Mayes,FR,2014-15,G,Florida State,ACC,32,1110,165,397,117,226,48,171,98,142,16,96,112,137,35,0,108,74,476
3872,Christian Vital,SO,2017-18,G,Connecticut,AAC,32,1013,138,360,70,146,68,214,132,156,25,148,173,53,50,1,56,73,476
3873,Jamel Artis,JR,2015-16,F,Pittsburgh,ACC,33,991,165,351,116,216,49,135,96,123,41,119,160,98,19,8,80,59,475
3874,Godwin Boahen,JR,2018-19,G,Illinois-Chicago,Horizon,32,1096,160,367,70,126,90,241,65,77,21,90,111,101,39,13,77,82,475
3875,Jason Calliste,JR,2012-13,G,Detroit Mercy,Horizon,33,1161,133,342,60,142,73,200,136,163,20,83,103,109,44,5,72,64,475
3876,Kyle Collinsworth,SO,2013-14,G,Brigham Young,WCC,34,1136,175,352,167,330,8,22,117,203,85,190,275,156,57,14,89,82,475
3877,Pat Connaughton,SR,2014-15,G,Notre Dame,ACC,38,1351,166,356,73,136,93,220,50,64,41,241,282,57,27,36,44,75,475
3878,Christen Cunningham,SO,2015-16,G,Samford,Southern,33,1114,161,357,142,287,19,70,134,162,17,76,93,128,34,2,87,54,475
3879,Kim English,SO,2009-10,G,Missouri,Big 12,34,818,156,397,88,213,68,184,95,130,29,86,115,39,45,3,71,58,475
3880,Dwayne Evans,SR,2013-14,F,Saint Louis,A-10,34,1005,168,340,163,322,5,18,134,179,66,156,222,42,41,20,82,96,475
3881,Zam Fredrick,JR,2007-08,G,South Carolina,SEC,32,1128,176,438,108,245,68,193,55,82,19,72,91,101,30,6,75,69,475
3882,Jordan Geist,SR,2018-19,G,Missouri,SEC,32,1080,155,352,90,168,65,184,100,132,26,122,148,97,34,0,69,56,475
3883,Shawn Glover,JR,2012-13,F,Oral Roberts,Southland,33,1082,199,399,191,363,8,36,69,97,57,110,167,64,40,44,70,60,475
3884,Johnny Gray,SR,2005-06,G,Pacific,Big West,32,1088,170,351,104,194,66,157,69,79,13,73,86,100,30,2,78,59,475
3885,Tucker Haymond,SR,2016-17,G,Western Michigan,MAC,32,1003,155,340,114,232,41,108,124,167,47,115,162,80,23,3,79,69,475
3886,Malcolm Hill,SO,2014-15,G,Illinois,Big Ten,33,1010,156,352,114,244,42,108,121,155,61,98,159,44,28,7,49,68,475
3887,Nathan Hoover,JR,2018-19,G,Wofford,Southern,35,1002,153,335,61,139,92,196,77,85,9,78,87,35,21,1,25,49,475
3888,Matt Howard,SO,2008-09,F,Butler,Horizon,32,888,148,269,146,260,2,9,177,229,82,134,216,36,25,48,52,101,475
3889,A.J. Jackson,JR,2005-06,F,Robert Morris,NEC,28,949,168,368,135,288,33,80,106,147,78,181,259,35,22,24,71,80,475
3890,Przemek Karnowski,SR,2016-17,C,Gonzaga,WCC,39,902,198,338,198,337,0,1,79,133,56,172,228,75,17,37,70,83,475
3891,Dwight Lewis,JR,2008-09,G,Southern California,Pac-10,33,1191,164,407,109,262,55,145,92,123,25,84,109,69,37,5,81,67,475
3892,Liam O'Reilly,SR,2017-18,G,Gardner-Webb,Big South,32,1091,166,403,81,182,85,221,58,69,11,139,150,120,33,2,95,58,475
3893,Sean Ogirri,SR,2008-09,G,Wyoming,MWC,33,1191,152,343,43,85,109,258,62,72,12,64,76,73,31,4,66,76,475
3894,Marcus Ottey,JR,2018-19,G,Illinois-Chicago,Horizon,32,1010,179,364,155,285,24,79,93,127,19,93,112,77,36,6,80,85,475
3895,Lorenzo Phillips,JR,2018-19,G,Longwood,Big South,34,1064,148,366,74,151,74,215,105,118,10,149,159,129,33,1,83,81,475
3896,Keith Rendelman,JR,2011-12,F,North Carolina-Wilmington,CAA,31,1024,186,351,186,350,0,1,103,164,117,194,311,37,41,33,66,101,475
3897,Julian Sensley,SR,2005-06,F,Hawaii,WAC,27,1000,174,390,124,243,50,147,77,117,45,111,156,87,34,14,65,45,475
3898,Josh Shipp,JR,2007-08,F,UCLA,Pac-10,39,1269,169,389,99,173,70,216,67,87,16,107,123,83,52,16,67,75,475
3899,Mike Smith,SO,2017-18,G,Columbia,Ivy,27,918,157,403,108,244,49,159,112,133,12,58,70,124,31,1,59,49,475
3900,Tavares Speaks,SR,2012-13,G,Liberty,Big South,36,1122,165,378,152,344,13,34,132,163,14,109,123,43,42,3,75,91,475
3901,Ethan Telfair,SR,2016-17,G,Idaho State,Big Sky,28,1013,146,429,104,296,42,133,141,183,21,100,121,134,56,6,96,60,475
3902,Obi Toppin,FR,2018-19,F,Dayton,A-10,33,873,201,302,190,281,11,21,62,87,50,136,186,61,21,28,63,70,475
3903,Phil Valenti,SR,2016-17,F,Canisius,MAAC,34,1026,181,361,150,270,31,91,82,103,62,139,201,82,36,4,64,93,475
3904,Fred VanVleet,JR,2014-15,G,Wichita State,MVC,35,1104,151,351,111,239,40,112,133,167,41,115,156,183,66,4,59,50,475
3905,Kori Babineaux,JR,2014-15,G,Jacksonville,A-Sun,32,1080,193,396,191,375,2,21,86,145,18,108,126,127,51,4,106,81,474
3906,Tyrone Bazy,SR,2006-07,G,Northern Arizona,Big Sky,30,796,159,314,149,275,10,39,146,178,27,60,87,75,33,2,86,86,474
3907,Leron Black,JR,2017-18,F,Illinois,Big Ten,31,789,188,344,166,301,22,43,76,95,55,106,161,26,10,8,56,104,474
3910,Aaron Brown,SR,2014-15,G,Boston College,ACC,32,1086,158,384,98,194,60,190,98,143,15,84,99,64,19,1,70,65,474
3911,Michael Carter-Williams,SO,2012-13,G,Syracuse,Big East,40,1409,155,394,120,275,35,119,129,186,51,148,199,291,109,20,138,92,474
3912,Louis Dabney,SR,2015-16,G,Tulane,AAC,33,1088,153,413,99,240,54,173,114,144,26,74,100,73,35,4,68,86,474
3913,Michael Dixon,JR,2011-12,G,Missouri,Big 12,35,934,154,316,104,180,50,136,116,132,10,53,63,116,41,3,56,64,474
3914,Shep Garner,SO,2015-16,G,Penn State,Big Ten,32,1127,149,390,74,185,75,205,101,129,9,94,103,109,42,7,65,59,474
3915,Steven Gray,SR,2010-11,G,Gonzaga,WCC,34,1075,159,388,88,197,71,191,85,112,21,111,132,136,57,3,73,82,474
3916,Jamar Gulley,SR,2013-14,F,Missouri State,MVC,33,883,170,369,144,283,26,86,108,147,67,144,211,52,52,11,56,103,474
3917,Adam Haluska,JR,2005-06,G,Iowa,Big Ten,34,1173,149,357,85,172,64,185,112,132,21,138,159,78,36,6,68,61,474
3918,Trevon Harmon,JR,2010-11,G,Cleveland State,Horizon,36,1195,161,367,100,186,61,181,91,115,45,99,144,46,55,0,47,72,474
3919,Delroy James,JR,2009-10,F,Rhode Island,A-10,36,974,165,393,119,250,46,143,98,133,79,112,191,57,52,45,73,87,474
3920,Tre Kelley,JR,2005-06,G,South Carolina,SEC,38,1330,166,398,99,206,67,192,75,98,22,88,110,174,50,5,103,74,474
3921,Tyler Larson,SR,2014-15,G,South Dakota,Summit,33,1141,156,362,124,276,32,86,130,173,74,185,259,95,26,8,70,85,474
3922,Devareaux Manley,SR,2014-15,G,Kent State,MAC,35,1139,144,361,30,74,114,287,72,93,15,84,99,29,20,6,37,64,474
3923,Jermaine Marshall,JR,2012-13,G,Penn State,Big Ten,31,1073,154,394,95,220,59,174,107,141,14,128,142,80,45,19,82,96,474
3924,Nick Masterson,SR,2017-18,G,Kennesaw State,A-Sun,30,1102,167,301,94,166,73,135,67,76,22,62,84,96,25,4,44,59,474
3925,Dominick Mejia,JR,2005-06,G,Drexel,CAA,31,981,152,410,60,162,92,248,78,93,21,85,106,70,35,5,81,49,474
3926,Eugene Myatt,SR,2008-09,F,Howard,MEAC,30,996,166,422,140,329,26,93,116,148,21,90,111,43,24,5,86,78,474
3927,Le'Bryan Nash,JR,2013-14,G,Oklahoma State,Big 12,34,1017,169,325,169,319,0,6,136,184,51,137,188,54,18,27,64,114,474
3928,Reeves Nelson,SO,2010-11,F,UCLA,Pac-10,34,1066,177,312,173,291,4,21,116,187,80,228,308,54,14,14,83,77,474
3929,LeRoy Nobles,JR,2009-10,G,IUPUI,Summit,36,1181,145,325,75,159,70,166,114,144,36,118,154,55,29,6,71,70,474
3932,Tanner Plomb,JR,2014-15,F,Army,Patriot,30,846,166,391,100,216,66,175,76,94,29,139,168,40,24,12,57,61,474
3933,DeWayne Reed,JR,2008-09,G,Auburn,SEC,36,1144,156,403,91,204,65,199,97,157,19,73,92,134,67,15,92,80,474
3934,Cameron Rundles,SR,2010-11,G,Wofford,Southern,34,1124,155,356,80,168,75,188,89,134,12,117,129,85,39,3,51,75,474
3935,Tevon Saddler,SR,2017-18,G,Nicholls State,Southland,30,878,162,343,143,272,19,71,131,171,45,154,199,85,48,7,95,89,474
3936,Micah Seaborn,FR,2015-16,G,Monmouth,MAAC,36,996,160,377,92,201,68,176,86,102,16,96,112,71,36,7,66,78,474
3937,Umar Shannon,SO,2010-11,G,Saint Francis (PA),NEC,30,959,146,356,78,177,68,179,114,142,26,64,90,59,14,0,66,57,474
3938,Marcus Shaver,SO,2018-19,G,Portland,WCC,32,1005,151,374,99,229,52,145,120,153,17,90,107,69,40,13,69,88,474
3939,Jaylen Shaw,SR,2017-18,G,Coastal Carolina,Sun Belt,32,989,157,374,123,266,34,108,126,163,10,92,102,172,51,1,112,71,474
3940,Nick Stallings,SR,2008-09,G,Centenary (LA),Summit,31,,173,405,117,262,56,143,72,116,,,189,66,49,15,94,,474
3941,Brock Stull,SO,2016-17,G,Milwaukee,Horizon,35,1167,173,390,116,245,57,145,71,88,37,195,232,100,27,1,76,65,474
3942,James Thompson IV,SO,2016-17,F,Eastern Michigan,MAC,32,988,178,310,177,309,1,1,117,164,152,206,358,32,24,29,64,101,474
3943,Shawne Williams,FR,2005-06,F,Memphis,CUSA,36,1002,156,375,108,221,48,154,114,145,62,160,222,67,50,49,81,105,474
3944,Chris Wright,SR,2010-11,F,Dayton,A-10,36,1038,179,390,174,368,5,22,111,185,83,218,301,66,28,51,102,101,474
3945,Miles Bridges,FR,2016-17,G,Michigan State,Big Ten,28,895,177,364,121,220,56,144,63,92,41,191,232,58,19,43,66,52,473
3946,Jacob Burtschi,SR,2006-07,F,Air Force,MWC,35,1122,168,337,106,178,62,159,75,97,49,161,210,80,55,3,35,84,473
3947,Jake Cohen,JR,2011-12,F,Davidson,Southern,33,818,151,310,121,228,30,82,141,161,69,133,202,45,24,55,68,100,473
3948,Devon Collier,SO,2011-12,F,Oregon State,Pac-12,36,964,176,286,176,286,0,0,121,192,89,98,187,63,36,46,49,74,473
3949,Spencer Collins,SR,2015-16,G,Wofford,Southern,32,1006,152,386,77,202,75,184,94,116,29,78,107,69,27,4,60,75,473
3950,Brian Conklin,SR,2011-12,F,Saint Louis,A-10,34,1001,158,303,157,301,1,2,156,195,67,89,156,42,24,11,71,90,473
3951,Kevin Dillard,SR,2012-13,G,Dayton,A-10,31,1023,139,343,84,204,55,139,140,157,12,48,60,141,34,4,98,65,473
3954,Deon Edwin,SR,2016-17,G,Kent State,MAC,36,1031,163,353,126,246,37,107,110,153,62,137,199,85,48,17,75,96,473
3955,Dominique Elliott,SR,2015-16,F,Maryland-Eastern Shore,MEAC,32,987,180,331,175,314,5,17,108,169,76,179,255,49,18,16,94,101,473
3956,Sterling Gibbs,JR,2014-15,G,Seton Hall,Big East,29,976,151,350,76,178,75,172,96,137,15,45,60,110,35,0,58,45,473
3957,Cedric Jackson,JR,2007-08,G,Cleveland State,Horizon,34,1058,148,353,102,235,46,118,131,191,25,141,166,168,88,10,131,97,473
3958,Dominic James,FR,2005-06,G,Marquette,Big East,31,1006,174,404,133,268,41,136,84,131,24,116,140,167,50,12,87,74,473
3959,Michael Jenkins,SR,2007-08,G,Winthrop,Big South,34,1083,166,399,92,198,74,201,67,94,31,110,141,85,38,14,63,79,473
3960,Xavier Johnson,SR,2016-17,G,Colorado,Pac-12,32,895,164,335,125,233,39,102,106,157,55,135,190,33,17,11,47,82,473
3961,Teyvion Kirk,FR,2017-18,G,Ohio,MAC,31,993,160,365,144,325,16,40,137,190,34,154,188,95,42,5,105,78,473
3962,Martin Krampelj,JR,2018-19,F,Creighton,Big East,35,888,177,299,151,229,26,70,93,147,60,181,241,28,38,29,55,99,473
3963,Oliver Lafayette,SR,2006-07,G,Houston,CUSA,33,1181,149,421,74,191,75,230,100,132,47,149,196,102,78,8,66,101,473
3964,Julian Mavunga,JR,2010-11,F,Miami (OH),MAC,32,1163,142,315,113,228,29,87,160,227,64,197,261,96,20,17,121,77,473
3965,Khris Middleton,SO,2010-11,F,Texas A&M,Big 12,33,978,159,353,120,245,39,108,116,148,64,108,172,93,39,2,89,70,473
3966,Deven Mitchell,SR,2007-08,F,Missouri State,MVC,33,923,156,289,154,282,2,7,159,178,69,133,202,25,47,18,76,94,473
3967,Mark Nwakamma,JR,2013-14,F,Hartford,AEC,31,910,171,324,158,283,13,41,118,173,55,126,181,60,23,23,95,109,473
3968,Rodney Pierce,JR,2008-09,G,Buffalo,MAC,33,1017,167,431,111,274,56,157,83,110,23,97,120,71,28,2,68,73,473
3969,Jesse Reed,JR,2014-15,G,American,Patriot,33,1269,158,336,112,207,46,129,111,144,23,141,164,44,33,19,62,75,473
3970,Nate Rohnert,JR,2008-09,G,Denver,Sun Belt,31,1147,166,337,131,230,35,107,106,148,24,142,166,146,40,10,105,88,473
3971,Amu Saaka,JR,2009-10,F,Furman,Southern,30,975,163,364,123,254,40,110,107,154,70,147,217,50,20,14,66,95,473
3972,Mike Schachtner,JR,2007-08,F,Green Bay,Horizon,30,883,166,341,129,260,37,81,104,115,47,80,127,19,10,2,43,67,473
3973,Jordan Sugars,SO,2009-10,G,Navy,Patriot,30,1066,169,372,91,187,78,185,57,86,84,155,239,39,38,4,64,74,473
3976,Devin Sweetney,SR,2009-10,G,Saint Francis (PA),NEC,28,899,142,340,108,236,34,104,155,187,60,146,206,60,34,15,91,70,473
3977,Tyler Tiedeman,SR,2007-08,G,Boise State,WAC,34,1074,153,289,69,117,84,172,83,111,22,92,114,105,17,10,85,92,473
3978,Reed Timmer,JR,2016-17,G,Drake,MVC,31,918,146,351,91,197,55,154,126,152,17,80,97,56,32,2,56,53,473
3979,Matt Van Scyoc,SO,2013-14,G,Citadel,Southern,33,1062,145,333,79,152,66,181,117,136,32,144,176,34,12,23,54,98,473
3980,Steve Vasturia,SR,2016-17,G,Notre Dame,ACC,36,1244,162,374,104,212,58,162,91,100,25,116,141,119,42,4,58,75,473
3981,Jaytornah Wisseh,SO,2007-08,G,Long Island University,NEC,30,1076,158,363,131,275,27,88,130,163,23,122,145,153,49,6,97,77,473
3982,Ron Baker,SO,2013-14,G,Wichita State,MVC,36,1075,146,320,78,141,68,179,112,133,27,110,137,112,51,23,61,66,472
3983,Ryan Boatright,JR,2013-14,G,Connecticut,AAC,39,1264,145,371,101,254,44,117,138,173,21,115,136,131,61,6,76,61,472
3984,Evan Boudreaux,SO,2016-17,F,Dartmouth,Ivy,27,903,166,378,129,273,37,105,103,148,56,201,257,26,21,14,80,59,472
3985,Brandon Bowdry,SO,2008-09,F,Eastern Michigan,MAC,32,945,169,379,152,319,17,60,117,170,75,155,230,58,27,8,124,96,472
3986,Sam Dekker,SO,2013-14,F,Wisconsin,Big Ten,38,1134,168,358,126,229,42,129,94,137,65,166,231,52,29,22,41,52,472
3987,Alihan Demir,JR,2018-19,F,Drexel,CAA,32,969,186,363,166,290,20,73,80,115,50,156,206,93,16,18,84,72,472
3988,Cole Dickerson,JR,2012-13,F,San Francisco,WCC,31,1024,175,369,127,252,48,117,74,127,81,223,304,42,29,10,78,82,472
3989,Marvin Dominique,SR,2014-15,F,Saint Peter's,MAAC,34,1096,167,362,130,260,37,102,101,135,84,162,246,17,30,22,51,89,472
3990,Malcolm Drumwright,SR,2017-18,G,Jacksonville State,OVC,36,1231,162,405,89,203,73,202,75,89,16,74,90,130,25,2,47,72,472
3991,Perry Ellis,SO,2013-14,F,Kansas,Big 12,35,973,174,317,166,300,8,17,116,152,72,162,234,36,29,20,40,76,472
3992,Matthew Fisher-Davis,JR,2016-17,G,Vanderbilt,SEC,34,947,145,359,61,133,84,226,98,121,11,98,109,35,21,8,52,70,472
3993,Kyle Fogg,SR,2011-12,G,Arizona,Pac-12,35,1124,140,333,68,171,72,162,120,152,17,114,131,76,37,13,63,78,472
3994,Joe Harden,SO,2008-09,G,UC-Davis,Big West,32,1050,143,345,119,258,24,87,162,203,53,176,229,58,30,9,84,98,472
3995,Jordan Heading,SR,2018-19,G,California Baptist,WAC,31,1003,175,380,115,214,60,166,62,75,14,106,120,81,19,1,86,72,472
3996,Kevin Huerter,SO,2017-18,G,Maryland,Big Ten,32,1101,162,322,89,147,73,175,75,99,31,130,161,108,20,21,80,76,472
3997,Matt Hunter,JR,2012-13,G,Central Connecticut State,NEC,30,1116,168,425,130,306,38,119,98,133,46,186,232,78,78,28,102,78,472
3998,A.J. Jackson,SR,2006-07,F,Robert Morris,NEC,28,991,173,371,132,254,41,117,85,100,56,161,217,33,20,28,55,72,472
3999,Lamont Mack,SR,2008-09,F,Charlotte,A-10,31,808,160,423,96,222,64,201,88,124,49,129,178,28,25,10,78,106,472
4000,Patrick Mills,FR,2007-08,G,Saint Mary's (CA),WCC,32,1027,161,375,100,186,61,189,89,117,14,53,67,111,57,3,91,50,472
4001,Wesley Myers,JR,2016-17,G,Maine,AEC,28,844,164,375,130,276,34,99,110,142,35,91,126,44,30,16,62,57,472
4002,Jacob Parker,SR,2014-15,F,Stephen F. Austin,Southland,34,922,157,307,102,182,55,125,103,123,58,129,187,55,37,14,55,95,472
4003,Curtis Phillips,SR,2017-18,F,Tennessee Tech,OVC,33,1011,152,387,91,208,61,179,107,149,34,137,171,72,59,20,99,69,472
4004,Jordan Poole,SO,2018-19,G,Michigan,Big Ten,37,1224,161,369,86,166,75,203,75,90,8,102,110,80,40,8,57,74,472
4005,Stanley Pringle,SR,2008-09,G,Penn State,Big Ten,37,1140,167,369,95,210,72,159,66,91,21,96,117,102,49,8,63,81,472
4006,Jacob Pullen,SO,2008-09,G,Kansas State,Big 12,34,1027,153,403,78,179,75,224,91,125,25,66,91,109,54,2,98,74,472
4007,Vova Severovas,SR,2006-07,F,Oakland,Mid-Cont,33,1099,135,278,135,277,0,1,202,246,79,109,188,71,29,0,74,86,472
4008,Joe Sherburne,SR,2018-19,F,Maryland-Baltimore County,AEC,34,1241,181,378,121,223,60,155,50,57,56,134,190,101,29,4,61,73,472
4009,Chris Silva,JR,2017-18,F,South Carolina,SEC,33,851,127,272,122,260,5,12,213,283,108,156,264,40,21,45,87,115,472
4010,Danny Stewart,SR,2013-14,F,Rider,MAAC,31,922,130,293,105,230,25,63,187,219,60,134,194,30,31,13,71,96,472
4011,Trey Sumler,SO,2011-12,G,Western Carolina,Southern,35,1269,150,357,101,230,49,127,123,148,37,133,170,145,48,2,114,76,472
4012,Marc Trasolini,JR,2010-11,F,Santa Clara,WCC,37,977,170,325,143,238,27,87,105,141,83,143,226,29,17,35,55,107,472
4013,Noah Allen,SR,2016-17,G,Hawaii,Big West,30,907,169,358,127,229,42,129,91,117,26,148,174,60,35,7,80,58,471
4014,Diante Baldwin,SR,2016-17,G,North Carolina-Greensboro,Southern,35,1073,171,400,128,285,43,115,86,118,29,95,124,149,63,6,93,69,471
4015,Ryan Betley,SO,2017-18,G,Pennsylvania,Ivy,33,1106,150,355,66,140,84,215,87,113,21,144,165,40,27,14,48,67,471
4018,Jaylen Bland,JR,2014-15,G,UC-Riverside,Big West,31,1103,151,395,56,150,95,245,74,92,24,124,148,49,43,11,55,59,471
4019,Desmond Cambridge,SO,2018-19,G,Brown,Ivy,30,860,162,436,86,197,76,239,71,92,15,100,115,28,30,52,52,71,471
4020,Rotnei Clarke,JR,2010-11,G,Arkansas,SEC,31,985,144,328,53,120,91,208,92,107,10,84,94,49,24,1,38,30,471
4021,Xavier Cooks,SO,2015-16,G,Winthrop,Big South,32,883,172,332,133,233,39,99,88,115,47,179,226,57,26,54,83,84,471
4022,JoJo Cooper,SR,2017-18,G,Wagner,NEC,33,1202,158,376,119,273,39,103,116,157,38,135,173,201,48,1,109,72,471
4023,CJ Elleby,FR,2018-19,F,Washington State,Pac-12,32,992,168,385,115,257,53,128,82,124,51,176,227,96,33,18,96,82,471
4024,Jordan Evans,JR,2017-18,SG,Mississippi Valley State,SWAC,32,960,159,432,103,270,56,162,97,130,28,69,97,64,33,1,63,93,471
4025,Trey Freeman,SO,2012-13,G,Campbell,Big South,33,1226,171,387,148,341,23,46,106,128,13,94,107,190,45,2,89,72,471
4026,Justin Hare,JR,2006-07,G,Belmont,A-Sun,33,1025,156,349,95,187,61,162,98,125,14,79,93,82,29,3,65,57,471
4027,Joseph Harris,SR,2008-09,F,Coastal Carolina,Big South,31,1022,190,330,190,329,0,1,91,144,127,225,352,63,45,36,97,91,471
4028,Jeremy Hence,SR,2010-11,F,Army,Patriot,30,969,173,338,133,224,40,114,85,124,62,96,158,56,24,11,73,58,471
4029,Jay Hook,JR,2013-14,G,Tulane,CUSA,34,1081,135,304,52,128,83,176,118,142,38,134,172,25,25,0,61,81,471
4030,Jordair Jett,SR,2013-14,G,Saint Louis,A-10,34,1073,169,345,162,308,7,37,126,210,32,105,137,164,51,18,97,63,471
4031,Isaiah Joe,FR,2018-19,G,Arkansas,SEC,34,1024,148,358,35,85,113,273,62,82,21,73,94,58,51,5,42,64,471
4032,Louie Krogman,SR,2011-12,G,South Dakota,Summit,28,1008,166,374,86,165,80,209,59,85,12,76,88,107,41,4,56,47,471
4033,Gani Lawal,JR,2009-10,F,Georgia Tech,ACC,36,930,172,325,172,324,0,1,127,222,105,200,305,15,16,49,78,76,471
4034,Keddric Mays,SR,2006-07,G,Chattanooga,Southern,33,1092,149,353,31,67,118,286,55,74,23,52,75,51,35,4,44,65,471
4035,Jalen Moore,JR,2015-16,F,Utah State,MWC,31,1091,170,387,120,237,50,150,81,113,44,142,186,82,25,18,48,54,471
4036,Nick Muszynski,FR,2018-19,C,Belmont,OVC,32,797,198,328,190,306,8,22,67,86,40,145,185,87,19,70,50,65,471
4037,Zach Norvell Jr.,FR,2017-18,G,Gonzaga,WCC,37,999,161,353,84,145,77,208,72,90,39,104,143,85,42,3,58,79,471
4040,Sollie Norwood,JR,2007-08,G,Texas Southern,SWAC,32,1103,152,406,72,171,80,235,87,109,30,94,124,34,38,1,71,52,471
4041,Corey Petros,SR,2014-15,C,Oakland,Horizon,33,1190,201,334,201,333,0,1,69,149,108,164,272,66,17,10,50,87,471
4042,Willie Powers,JR,2009-10,G,Georgia Southern,Southern,32,1037,157,365,127,263,30,102,127,159,27,79,106,175,41,3,118,79,471
4043,J-Mychal Reese,JR,2015-16,G,North Texas,CUSA,32,1073,164,390,126,266,38,124,105,138,17,76,93,118,34,0,101,76,471
4044,Magnum Rolle,SR,2009-10,F,Louisiana Tech,WAC,34,1025,189,368,189,368,0,0,93,141,120,166,286,28,26,71,67,95,471
4045,Myles Taylor,SO,2012-13,F,Tennessee-Martin,OVC,29,806,158,336,148,305,10,31,145,194,78,131,209,21,25,14,60,110,471
4046,Kevin Thompson,SO,2009-10,F,Morgan State,MEAC,37,1147,186,357,186,356,0,1,99,165,179,259,438,67,20,53,77,115,471
4047,Tristan Thompson,FR,2010-11,F,Texas,Big 12,36,1104,172,315,172,315,0,0,127,261,138,144,282,45,34,86,64,100,471
4048,Jamarco Warren,JR,2009-10,G,Charleston Southern,Big South,30,989,161,409,79,178,82,231,67,92,16,75,91,84,52,2,86,66,471
4049,Desmond Williams,JR,2016-17,F,Florida A&M,MEAC,29,936,182,377,182,372,0,5,107,172,45,132,177,44,29,35,63,58,471
4050,James Williams,SR,2006-07,G,Long Island University,NEC,29,1012,150,399,74,181,76,218,95,113,16,62,78,54,18,1,81,66,471
4051,Noruwa Agho,JR,2010-11,G,Columbia,Ivy,28,966,166,386,125,279,41,107,97,149,30,108,138,119,27,16,89,63,470
4052,Ian Baker,JR,2015-16,G,New Mexico State,WAC,34,1114,156,367,87,187,69,180,89,109,21,136,157,124,37,4,75,49,470
4053,Jimmy Baron,JR,2007-08,G,Rhode Island,A-10,33,933,149,347,50,103,99,244,73,80,24,44,68,64,18,1,38,49,470
4054,Jacobi Boykins,JR,2016-17,G,Louisiana Tech,CUSA,32,967,153,333,64,115,89,218,75,93,25,124,149,70,65,18,35,72,470
4055,Malcolm Brogdon,SO,2013-14,G,Virginia,ACC,37,1163,150,363,106,244,44,119,126,144,33,168,201,101,44,5,53,71,470
4056,Dee Brown,SR,2005-06,G,Illinois,Big Ten,33,1183,157,437,79,194,78,243,78,103,15,87,102,191,53,1,94,61,470
4057,Lorenzo Brown,SO,2011-12,G,North Carolina State,ACC,37,1268,165,367,138,290,27,77,113,155,28,140,168,234,67,20,118,58,470
4058,Sterling Brown,SR,2016-17,G,Southern Methodist,AAC,35,1143,161,351,100,215,61,136,87,110,55,172,227,105,50,19,69,91,470
4059,Kyvon Davenport,SR,2018-19,F,Memphis,AAC,36,940,171,341,134,237,37,104,91,152,85,163,248,36,24,28,55,122,470
4062,Tyreek Duren,SR,2013-14,G,La Salle,A-10,31,1121,147,353,89,211,58,142,118,147,18,87,105,108,51,9,58,61,470
4063,Erik Etherly,SR,2012-13,F,Loyola (MD),MAAC,30,1018,162,371,160,361,2,10,144,213,63,132,195,48,45,29,70,63,470
4064,Aaron Gordon,FR,2013-14,F,Arizona,Pac-12,38,1187,189,382,173,337,16,45,76,180,102,201,303,75,34,39,55,90,470
4065,TJ Haws,FR,2016-17,G,Brigham Young,WCC,34,1040,147,347,71,159,76,188,100,127,9,88,97,110,34,4,86,77,470
4066,Kyle Hittle,SR,2015-16,G,Incarnate Word,Southland,29,970,158,328,86,157,72,171,82,112,33,138,171,67,34,3,44,73,470
4067,Austin Hollins,SR,2013-14,G,Minnesota,Big Ten,38,1258,161,362,97,177,64,185,84,109,61,128,189,91,75,19,59,69,470
4068,Demetrius Jackson,SO,2014-15,G,Notre Dame,ACC,38,1318,167,329,113,203,54,126,82,110,44,93,137,116,59,12,57,71,470
4069,Kris Jenkins,SR,2016-17,F,Villanova,Big East,36,1118,142,370,56,131,86,239,100,116,13,136,149,73,40,10,52,69,470
4070,Jarrod Jones,JR,2010-11,F,Ball State,MAC,32,945,181,357,181,350,0,7,108,161,71,199,270,37,26,22,57,74,470
4071,Rob Jones,JR,2010-11,F,Saint Mary's (CA),WCC,34,1068,176,379,122,216,54,163,64,89,60,203,263,58,36,18,70,103,470
4072,Marcus Jordan,SO,2010-11,G,Central Florida,CUSA,31,980,136,336,95,208,41,128,157,203,13,73,86,103,27,2,89,52,470
4073,Corey Lowe,SO,2007-08,G,Boston University,AEC,26,880,164,404,72,156,92,248,50,82,19,78,97,86,25,5,83,67,470
4074,Skylar Mays,JR,2018-19,G,Louisiana State,SEC,35,1159,143,340,88,164,55,176,129,150,14,100,114,72,66,8,43,60,470
4075,Jalen Moore,SO,2014-15,F,Utah State,MWC,31,1066,157,319,112,204,45,115,111,149,36,173,209,53,19,27,37,44,470
4076,Miguel Paul,JR,2011-12,G,East Carolina,CUSA,31,976,132,342,64,154,68,188,138,180,9,53,62,183,39,3,88,76,470
4077,Adam Pegg,SR,2012-13,C,Stetson,A-Sun,30,851,193,360,171,301,22,59,62,92,50,140,190,30,13,11,65,71,470
4078,Quinton Pippen,SR,2013-14,G,Chicago State,WAC,31,964,153,388,63,145,90,243,74,91,22,97,119,79,57,7,70,98,470
4079,Bryce Pressley,SR,2015-16,G,Portland,WCC,32,1005,170,364,107,200,63,164,67,89,41,105,146,78,41,17,36,64,470
4080,Omar Prewitt,SR,2016-17,F,William & Mary,CAA,30,948,175,378,130,244,45,134,75,116,31,155,186,96,25,19,62,64,470
4081,Ryan Rossiter,JR,2009-10,F,Siena,MAAC,34,1120,172,301,171,295,1,6,125,163,130,249,379,34,47,35,46,87,470
4084,Clint Sargent,SR,2010-11,G,South Dakota State,Summit,31,998,158,385,75,172,83,213,71,89,14,84,98,40,17,2,31,50,470
4085,Sylvester Seay,SR,2009-10,F,Fresno State,WAC,33,971,168,372,132,246,36,126,98,136,64,136,200,48,34,36,69,89,470
4086,Nych Smith,SR,2018-19,G,Winthrop,Big South,28,769,167,373,118,226,49,147,87,115,12,62,74,103,15,0,67,56,470
4087,Ryan Taylor,JR,2015-16,F,Marshall,CUSA,33,882,168,303,146,236,22,67,112,173,66,152,218,99,35,25,80,124,470
4088,Reid Travis,JR,2016-17,F,Stanford,Pac-12,27,813,176,304,176,303,0,1,118,181,93,146,239,14,14,5,56,64,470
4089,Lagerald Vick,JR,2017-18,G,Kansas,Big 12,39,1289,187,383,128,225,59,158,37,55,37,150,187,83,34,13,64,74,470
4090,Christian Vital,JR,2018-19,G,Connecticut,AAC,33,996,150,331,71,138,79,193,91,112,34,151,185,79,52,1,77,82,470
4091,Corey Walden,JR,2013-14,G,Eastern Kentucky,OVC,34,1072,151,304,112,184,39,120,129,155,25,115,140,100,76,1,69,121,470
4092,Darius Washington,SO,2005-06,G,Memphis,CUSA,35,928,153,362,108,236,45,126,119,152,33,64,97,110,45,3,111,62,470
4093,B.J. Young,SO,2012-13,G,Arkansas,SEC,31,866,180,401,155,291,25,110,85,127,32,78,110,105,21,8,64,52,470
4094,J.R. Blount,JR,2007-08,G,Loyola (IL),Horizon,31,1073,163,421,136,307,27,114,116,162,41,84,125,82,38,1,82,93,469
4095,Evan Bradds,SO,2014-15,G,Belmont,OVC,33,928,185,269,180,256,5,13,94,145,65,171,236,44,21,7,83,74,469
4096,David Caraher,FR,2017-18,F,Houston Baptist,Southland,29,908,162,356,106,202,56,154,89,121,70,138,208,56,24,4,69,83,469
4097,Keith Clanton,SO,2010-11,F,Central Florida,CUSA,33,1006,164,310,143,254,21,56,120,176,81,173,254,53,33,60,76,85,469
4098,Rotnei Clarke,SO,2009-10,G,Arkansas,SEC,31,1058,151,332,51,98,100,234,67,81,5,69,74,37,36,3,36,32,469
4099,Nolan Cressler,SO,2013-14,G,Cornell,Ivy,28,912,169,411,101,224,68,187,63,81,20,98,118,45,14,2,59,78,469
4100,Kendrick Davis,JR,2005-06,G,North Texas,Sun Belt,28,856,159,390,99,218,60,172,91,116,16,59,75,68,42,1,68,68,469
4101,Shawntrez Davis,JR,2017-18,F,Bethune-Cookman,MEAC,32,863,181,327,158,266,23,61,84,142,86,191,277,40,15,39,78,109,469
4102,Stacy Davis,SO,2013-14,F,Pepperdine,WCC,31,910,155,329,132,280,23,49,136,179,66,170,236,48,14,20,68,73,469
4103,Justin Drummond,JR,2013-14,G,Toledo,MAC,33,909,146,288,121,210,25,78,152,208,49,121,170,87,34,13,58,88,469
4104,Perry Ellis,JR,2014-15,F,Kansas,Big 12,34,978,166,363,148,317,18,46,119,163,74,160,234,42,28,23,58,81,469
4105,Dion Harris,SR,2006-07,G,Michigan,Big Ten,35,1147,147,392,75,191,72,201,103,120,12,72,84,127,38,3,97,66,469
4106,Jalen Henry,JR,2017-18,F,Southern Illinois-Edwardsville,OVC,29,815,157,374,120,272,37,102,118,165,45,166,211,34,23,24,73,84,469
4107,DeQuan Hicks,SR,2013-14,F,Northwestern State,Southland,31,758,166,352,164,338,2,14,135,198,80,146,226,82,44,19,101,78,469
4108,Keonta Howell,SR,2006-07,F,Toledo,MAC,32,1023,170,373,106,192,64,181,65,84,38,109,147,40,37,8,53,93,469
4109,ShawnDre' Jones,JR,2015-16,G,Richmond,A-10,31,1073,157,363,97,210,60,153,95,115,17,53,70,114,23,2,50,82,469
4110,Terrence Jones,SO,2011-12,F,Kentucky,SEC,38,1115,177,354,161,305,16,49,99,158,96,176,272,51,49,68,62,91,469
4111,Harper Kamp,JR,2010-11,F,University of California,Pac-10,33,1085,169,320,167,310,2,10,129,158,69,115,184,55,19,9,75,92,469
4112,Doron Lamb,FR,2010-11,G,Kentucky,SEC,38,1078,161,324,93,184,68,140,79,100,19,56,75,62,22,6,50,85,469
4113,Jack Leasure,JR,2006-07,G,Coastal Carolina,Big South,30,1039,163,397,73,155,90,242,53,63,13,73,86,108,46,0,59,44,469
4114,Jack Leasure,SR,2007-08,G,Coastal Carolina,Big South,28,1044,155,368,44,99,111,269,48,55,23,98,121,64,24,3,57,43,469
4115,Jaren Lewis,SR,2018-19,F,Abilene Christian,Southland,34,1056,178,382,164,340,14,42,99,135,77,131,208,93,54,22,60,66,469
4116,Mickey McConnell,JR,2009-10,G,Saint Mary's (CA),WCC,34,1229,159,313,82,162,77,151,74,88,15,66,81,174,50,8,74,71,469
4117,Brandon Paul,JR,2011-12,G,Illinois,Big Ten,32,1070,145,370,91,208,54,162,125,172,30,121,151,94,46,27,109,84,469
4118,Vasa Pusica,SR,2018-19,G,Northeastern,CAA,27,941,151,313,92,165,59,148,108,129,11,91,102,111,40,6,85,56,469
4119,Ivan Radenovic,SR,2006-07,F,Arizona,Pac-10,31,1063,150,296,131,245,19,51,150,172,86,150,236,64,27,18,65,73,469
4120,Brandon Reed,FR,2009-10,G,Arkansas State,Sun Belt,31,1032,168,428,110,255,58,173,75,106,30,75,105,76,22,5,76,49,469
4121,Laquincy Rideau,SO,2016-17,G,Gardner-Webb,Big South,33,950,157,334,127,257,30,77,125,216,45,144,189,171,100,10,112,99,469
4122,Jalen Riley,JR,2013-14,G,East Tennessee State,A-Sun,35,735,125,343,75,188,50,155,169,202,21,67,88,64,31,6,53,76,469
4123,Jonathan Rodriguez,JR,2008-09,F,Campbell,A-Sun,30,911,163,344,144,291,19,53,124,157,91,157,248,57,38,9,80,62,469
4126,Deville Smith,SR,2014-15,G,Tennessee-Martin,OVC,34,1220,170,410,109,220,61,190,68,103,18,135,153,153,59,19,102,69,469
4127,Eric Smith,JR,2005-06,G,Campbell,A-Sun,28,843,149,353,42,85,107,268,64,93,31,72,103,67,36,8,70,64,469
4128,Justin Stommes,JR,2009-10,G,Eastern Kentucky,OVC,33,1069,159,305,98,158,61,147,90,116,10,114,124,117,32,9,76,49,469
4129,Daniel Utomi,JR,2018-19,F,Akron,MAC,33,1107,162,402,69,153,93,249,52,77,37,143,180,42,19,13,58,83,469
4130,David Walker,JR,2014-15,G,Northeastern,CAA,35,1298,142,325,73,149,69,176,116,134,10,111,121,126,41,10,78,28,469
4131,Demetrius Ward,JR,2010-11,G,Western Michigan,MAC,34,1087,143,352,78,188,65,164,118,153,42,103,145,84,37,3,73,85,469
4132,Lucas Woodhouse,SR,2016-17,G,Stony Brook,AEC,31,992,146,318,80,174,66,144,111,127,13,91,104,158,34,0,61,52,469
4133,Brandon Anderson,SO,2017-18,G,Brown,Ivy,27,915,133,352,100,238,33,114,169,196,18,54,72,105,40,3,81,61,468
4134,Eddie Ard,SR,2007-08,G,Lipscomb,A-Sun,31,966,157,391,101,230,56,161,98,133,25,117,142,64,39,20,73,69,468
4135,Logan Aronhalt,SO,2010-11,G,Albany (NY),AEC,32,1107,163,422,90,227,73,195,69,91,51,100,151,43,22,9,61,40,468
4136,John Baumann,SR,2007-08,F,Columbia,Ivy,29,911,160,311,135,228,25,83,123,164,65,129,194,31,18,9,58,75,468
4137,Dee Bost,SO,2009-10,G,Mississippi State,SEC,36,1255,147,367,77,168,70,199,104,144,19,139,158,188,47,7,118,71,468
4138,T.J. Bray,SR,2013-14,G,Princeton,Ivy,26,920,152,283,100,157,52,126,112,140,13,111,124,133,34,5,46,51,468
4139,Elijah Bryant,FR,2014-15,G,Elon,CAA,33,840,147,385,103,259,44,126,130,173,45,93,138,89,42,13,115,87,468
4140,Johnnie Bryant,SR,2007-08,G,Utah,MWC,33,891,160,325,71,124,89,201,59,64,8,65,73,39,26,0,40,63,468
4141,Desmond Cambridge,FR,2017-18,G,Brown,Ivy,27,809,160,399,92,196,68,203,80,104,25,97,122,33,29,27,39,77,468
4142,Josh Cameron,JR,2013-14,G,Coastal Carolina,Big South,34,946,147,379,81,205,66,174,108,143,11,75,86,86,33,8,93,72,468
4143,Josh Carter,SR,2008-09,F,Texas A&M,Big 12,34,1041,143,330,66,137,77,193,105,124,36,111,147,59,28,8,38,48,468
4144,Elgin Cook,JR,2014-15,F,Oregon,Pac-12,36,1059,169,325,164,305,5,20,125,171,52,136,188,59,38,6,80,117,468
4145,Isaiah Cousins,SR,2015-16,G,Oklahoma,Big 12,37,1232,169,416,104,258,65,158,65,97,23,142,165,168,51,10,88,63,468
4148,Jon Diebler,SR,2010-11,G,Ohio State,Big Ten,37,1320,145,286,31,59,114,227,64,79,14,84,98,88,36,5,35,37,468
4149,Jacob Evans,JR,2017-18,G,Cincinnati,AAC,36,1107,161,377,101,215,60,162,86,114,50,120,170,113,47,35,63,72,468
4150,Demetrious Floyd,SR,2015-16,G,Stephen F. Austin,Southland,34,832,173,375,73,139,100,236,22,31,9,43,52,50,40,3,32,45,468
4151,Roberto Gallinat,JR,2017-18,G,Pacific,WCC,32,1023,153,349,102,190,51,159,111,144,26,64,90,37,20,7,47,79,468
4152,Greg Gantt,FR,2009-10,G,Florida Atlantic,Sun Belt,30,929,166,390,81,172,85,218,51,72,31,42,73,31,20,3,24,39,468
4153,Adam Grant,JR,2018-19,G,Bryant,NEC,30,1065,162,393,82,186,80,207,64,81,25,63,88,46,34,3,56,67,468
4154,Mike Groselle,SR,2012-13,C,Citadel,Southern,30,952,189,329,189,329,0,0,90,121,93,135,228,47,39,18,66,73,468
4155,Richard Hendrix,SO,2006-07,F,Alabama,SEC,32,883,186,309,185,304,1,5,95,151,106,173,279,60,17,41,69,96,468
4156,Solomon Hill,SR,2012-13,F,Arizona,Pac-12,35,1154,158,345,101,199,57,146,95,124,61,126,187,95,40,20,77,76,468
4157,Kerron Johnson,JR,2011-12,G,Belmont,A-Sun,34,972,145,280,121,202,24,78,154,201,22,83,105,177,48,1,81,80,468
4158,Mike Jones,SR,2006-07,G,Maryland,ACC,34,884,167,356,86,172,81,184,53,67,29,81,110,47,28,8,49,65,468
4159,Devoe Joseph,SR,2011-12,G,Oregon,Pac-12,28,989,166,351,100,193,66,158,70,88,18,87,105,91,38,4,52,43,468
4160,Daniel Kickert,SR,2005-06,F,Saint Mary's (CA),WCC,28,937,157,346,98,217,59,129,95,108,32,124,156,29,17,19,70,66,468
4161,Egor Koulechov,SR,2017-18,G,Florida,SEC,34,1040,161,390,91,213,70,177,76,88,57,161,218,40,21,4,44,74,468
4162,David Lighty,JR,2009-10,G,Ohio State,Big Ten,37,1344,164,333,120,218,44,115,96,152,53,115,168,110,58,20,85,90,468
4163,James McGee,JR,2016-17,G,Southern Utah,Big Sky,33,1116,138,345,37,105,101,240,91,126,16,72,88,84,27,4,59,83,468
4164,Tymell Murphy,JR,2012-13,F,Florida International,Sun Belt,32,974,196,342,184,304,12,38,64,95,75,143,218,62,55,36,81,90,468
4165,Divine Myles,SO,2015-16,G,Stetson,A-Sun,34,1103,174,341,148,273,26,68,94,142,22,132,154,143,46,4,57,76,468
4166,Laquincy Rideau,JR,2018-19,G,South Florida,AAC,35,1124,162,396,108,236,54,160,90,164,33,98,131,189,101,5,126,125,468
4167,Yettra Specks,SR,2016-17,G,Jackson State,SWAC,32,1175,143,377,73,163,70,214,112,131,23,80,103,85,37,4,59,78,468
4170,Kevin Tiggs,JR,2007-08,F,East Tennessee State,A-Sun,32,949,170,310,160,279,10,31,118,150,92,85,177,50,48,6,102,77,468
4171,Lucas Troutman,JR,2012-13,F,Elon,Southern,31,819,194,355,194,353,0,2,80,119,62,101,163,20,37,64,64,73,468
4172,B.J. Tyson,SO,2015-16,G,East Carolina,AAC,32,1071,173,412,129,262,44,150,78,106,25,116,141,82,31,4,73,55,468
4173,Dimencio Vaughn,FR,2017-18,G,Rider,MAAC,29,804,164,323,137,246,27,77,113,148,74,119,193,31,53,21,69,83,468
4174,Harold Washington,SR,2012-13,G,Canisius,MAAC,34,1089,152,345,93,201,59,144,105,137,22,65,87,77,31,2,98,69,468
4175,Kaleb Wesson,SO,2018-19,F,Ohio State,Big Ten,32,829,156,312,130,237,26,75,130,177,77,144,221,59,33,21,73,103,468
4176,Nigel Williams-Goss,SO,2014-15,G,Washington,Pac-12,30,1104,186,421,164,335,22,86,74,97,20,121,141,177,33,5,85,56,468
4177,Ray Willis,JR,2011-12,G,North Carolina Central,MEAC,32,1036,137,317,113,241,24,76,170,214,37,142,179,87,43,23,110,74,468
4178,Rosco Allen,SR,2015-16,F,Stanford,Pac-12,30,1018,142,335,86,169,56,166,127,172,48,146,194,50,35,5,60,84,467
4179,Udoka Azubuike,SO,2017-18,C,Kansas,Big 12,36,848,211,274,211,274,0,0,45,109,87,165,252,24,20,60,63,108,467
4180,Jimmy Baron,SO,2006-07,G,Rhode Island,A-10,32,905,149,306,52,103,97,203,72,81,14,55,69,63,16,0,42,40,467
4181,Jamari Blackmon,FR,2018-19,G,North Alabama,A-Sun,32,1130,137,421,69,187,68,234,125,163,26,85,111,87,56,6,60,82,467
4182,De'Mon Brooks,JR,2012-13,F,Davidson,Southern,34,919,170,340,161,299,9,41,118,158,76,135,211,26,30,21,66,98,467
4183,Remond Brown,SR,2016-17,G,Grambling,SWAC,33,1087,183,396,148,291,35,105,66,100,38,109,147,59,61,14,84,73,467
4184,Tyler Brown,JR,2011-12,G,Illinois State,MVC,34,1053,153,337,74,163,79,174,82,104,27,101,128,79,34,4,86,62,467
4185,Wayne Chism,JR,2008-09,F,Tennessee,SEC,34,873,165,354,124,226,41,128,96,134,94,179,273,42,26,34,69,98,467
4186,Wayne Chism,SR,2009-10,F,Tennessee,SEC,37,998,169,363,134,255,35,108,94,124,74,192,266,40,41,48,60,102,467
4187,Marquese Chriss,FR,2015-16,F,Washington,Pac-12,34,848,179,338,158,278,21,60,88,129,85,98,183,26,32,55,69,138,467
4188,Aaron Cosby,SR,2015-16,G,Western Kentucky,CUSA,34,1073,137,390,56,169,81,221,112,131,16,108,124,67,15,5,67,47,467
4189,Jason Flagler,SR,2009-10,G,South Carolina State,MEAC,31,1066,201,366,200,363,1,3,64,74,42,128,170,33,20,11,46,65,467
4192,Stone Gettings,JR,2017-18,F,Cornell,Ivy,28,749,165,339,122,222,43,117,94,114,39,147,186,80,20,13,63,79,467
4193,Javonte Green,SO,2012-13,F,Radford,Big South,32,885,178,353,173,327,5,26,106,179,94,164,258,43,66,23,66,88,467
4194,Michael Hale,JR,2012-13,G,Texas-San Antonio,WAC,30,1087,148,371,89,204,59,167,112,148,15,77,92,115,44,0,82,72,467
4195,Jaylen Hands,SO,2018-19,G,UCLA,Pac-12,33,1029,158,383,92,206,66,177,85,109,12,109,121,201,44,5,105,40,467
4196,Braxton Huggins,JR,2016-17,G,New Mexico State,WAC,34,940,140,319,51,107,89,212,98,121,15,75,90,45,11,8,52,63,467
4197,Desmar Jackson,SR,2012-13,G,Southern Illinois,MVC,31,923,168,383,130,264,38,119,93,135,49,118,167,61,58,15,84,90,467
4198,Ben Jacobson,SR,2005-06,G,Northern Iowa,MVC,33,1196,158,406,100,229,58,177,93,120,18,111,129,124,51,5,86,53,467
4199,Shawn Jones,SR,2013-14,F,Middle Tennessee,CUSA,33,930,183,317,183,316,0,1,101,147,99,180,279,20,30,63,48,91,467
4200,Jared Jordan,JR,2005-06,G,Marist,MAAC,29,1130,167,343,106,180,61,163,72,97,32,106,138,247,50,1,92,46,467
4201,Colter Lasher,SR,2016-17,F,Houston Baptist,Southland,31,904,167,385,109,224,58,161,75,97,27,101,128,86,29,16,65,61,467
4202,Gani Lawal,SO,2008-09,F,Georgia Tech,ACC,31,919,184,331,184,330,0,1,99,177,111,183,294,19,31,46,79,80,467
4203,Adam Leonard,JR,2009-10,G,Missouri State,MVC,36,1178,149,375,46,111,103,264,66,84,6,79,85,78,20,1,55,41,467
4204,Tyrone Lewis,SO,2007-08,G,Niagara,MAAC,29,1011,149,381,86,182,63,199,106,150,45,76,121,57,58,17,65,85,467
4205,Derrick Low,JR,2006-07,G,Washington State,Pac-10,34,1170,166,372,91,184,75,188,60,76,8,65,73,73,45,5,46,62,467
4206,Harris Mansell,JR,2007-08,G,Rider,MAAC,34,1044,148,325,68,146,80,179,91,117,24,86,110,64,32,4,55,69,467
4207,Koby McEwen,SO,2017-18,G,Utah State,MWC,30,970,150,375,83,172,67,203,100,138,13,150,163,97,23,1,89,78,467
4208,Tyrell Nelson,JR,2015-16,C,Gardner-Webb,Big South,33,898,181,324,176,307,5,17,100,163,102,150,252,53,21,26,86,87,467
4209,David Nichols,JR,2017-18,G,Albany (NY),AEC,32,1082,166,421,109,265,57,156,78,101,16,120,136,111,37,7,80,84,467
4210,Chris Perez,JR,2012-13,G,Stetson,A-Sun,31,949,172,354,149,280,23,74,100,149,58,69,127,58,35,0,81,86,467
4211,Lance Perique,SR,2006-07,F,Georgia State,CAA,30,949,157,321,143,274,14,47,139,205,57,94,151,30,19,7,82,78,467
4212,Steffphon Pettigrew,SR,2010-11,F,Western Kentucky,Sun Belt,32,1085,182,372,152,270,30,102,73,127,83,111,194,42,24,20,64,88,467
4213,Will Rayman,FR,2016-17,F,Colgate,Patriot,32,941,154,347,89,183,65,164,94,136,45,102,147,31,22,13,69,91,467
4214,Cameron Reynolds,SR,2017-18,G,Tulane,AAC,31,1117,171,419,110,246,61,173,64,91,36,160,196,68,24,18,47,77,467
4215,Erik Rush,SR,2010-11,G,Montana State,Big Sky,31,987,150,349,112,223,38,126,129,183,35,93,128,88,43,9,72,75,467
4216,Jarvis Threatt,JR,2013-14,G,Delaware,CAA,26,964,138,334,128,288,10,46,181,262,35,116,151,141,64,4,66,55,467
4217,Jerome Tillman,SO,2006-07,F,Ohio,MAC,32,1037,162,289,139,238,23,51,120,176,97,164,261,42,31,15,57,93,467
4218,Jordon Varnado,JR,2017-18,F,Troy,Sun Belt,26,810,174,364,148,274,26,90,93,126,49,134,183,44,18,36,56,71,467
4219,Dion Waiters,SO,2011-12,G,Syracuse,Big East,37,891,170,357,129,244,41,113,86,118,18,67,85,92,67,12,48,69,467
4220,Gary Wilkinson,JR,2007-08,F,Utah State,WAC,35,976,174,298,165,266,9,32,110,135,73,173,246,41,16,22,63,70,467
4221,Terry Winn,SR,2018-19,F,Texas-Rio Grande Valley,WAC,37,1097,166,373,165,360,1,13,134,188,30,143,173,60,35,6,83,64,467
4222,Wade Baldwin,SO,2015-16,G,Vanderbilt,SEC,33,1002,135,316,94,215,41,101,155,194,13,119,132,172,40,11,91,85,466
4223,Levi Bradley,JR,2017-18,G,Northern Illinois,MAC,32,947,162,379,136,286,26,93,116,140,41,135,176,24,28,8,42,88,466
4224,Darien Brothers,JR,2011-12,G,Richmond,A-10,32,971,146,345,78,164,68,181,106,119,19,75,94,53,28,2,44,74,466
4225,Omar Carter,FR,2007-08,G,Charleston Southern,Big South,30,835,165,375,110,222,55,153,81,110,56,139,195,50,36,6,72,75,466
4226,Warren Carter,SR,2006-07,F,Illinois,Big Ten,34,1047,167,344,136,270,31,74,101,142,61,148,209,68,24,32,90,87,466
4227,Tahj Eaddy,SO,2018-19,G,Santa Clara,WCC,31,1099,152,379,75,176,77,203,85,106,9,74,83,98,28,0,62,63,466
4228,Roderick Flemings,SR,2009-10,F,Hawaii,WAC,28,988,173,398,155,323,18,75,102,156,59,115,174,63,21,10,58,64,466
4229,Jarell Flora,SR,2014-15,G,Seattle,WAC,34,1097,166,383,86,185,80,198,54,66,19,125,144,51,29,9,73,50,466
4230,Dairese Gary,SR,2010-11,G,New Mexico,MWC,33,1117,134,279,99,175,35,104,163,209,21,84,105,182,43,1,92,76,466
4231,Archie Goodwin,FR,2012-13,G,Kentucky,SEC,33,1048,157,357,140,293,17,64,135,212,48,104,152,88,36,15,101,97,466
4234,Bobby Hain,JR,2014-15,F,Youngstown State,Horizon,32,1018,181,352,174,321,7,31,97,137,75,163,238,65,18,20,56,82,466
4235,Damon Heuir,SR,2012-13,G,Southern Utah,Big Sky,30,932,147,397,90,223,57,174,115,150,36,84,120,96,24,6,100,74,466
4236,Leonard Houston,SR,2007-08,G,Drake,MVC,33,1042,156,370,101,210,55,160,99,129,46,101,147,60,47,8,64,57,466
4237,Elijah Hughes,JR,2018-19,F,Syracuse,ACC,34,1111,155,369,68,133,87,236,69,93,23,124,147,50,42,27,63,72,466
4238,Sylven Landesberg,SO,2009-10,G,Virginia,ACC,27,868,166,375,143,315,23,60,111,137,37,95,132,77,21,8,61,57,466
4239,Kevin Larsen,SR,2015-16,F,George Washington,A-10,38,1287,165,331,148,295,17,36,119,165,108,204,312,100,36,27,70,83,466
4240,Nathaniel Lester,SR,2011-12,F,Hofstra,CAA,32,1036,153,385,134,312,19,73,141,183,92,117,209,32,43,15,56,81,466
4241,JaVale McGee,SO,2007-08,F,Nevada,WAC,33,902,189,357,175,315,14,42,74,141,83,159,242,20,26,92,80,82,466
4242,Jordan McLaughlin,JR,2016-17,G,Southern California,Pac-12,36,1228,162,353,115,236,47,117,95,119,29,99,128,197,53,4,80,35,466
4243,Kojo Mensah,SO,2005-06,G,Siena,MAAC,28,984,146,336,137,298,9,38,165,232,87,88,175,114,71,5,102,62,466
4244,Nic Moore,SR,2015-16,G,Southern Methodist,AAC,29,996,153,364,77,180,76,184,84,105,9,61,70,152,39,3,66,64,466
4245,Demetris Nichols,JR,2005-06,F,Syracuse,Big East,35,1164,165,386,92,185,73,201,63,93,61,143,204,50,45,33,63,96,466
4246,Alex Petrie,FR,2017-18,G,Lafayette,Patriot,31,772,156,358,88,190,68,168,86,95,9,66,75,23,14,0,58,22,466
4247,Jordan Reed,FR,2012-13,G,Binghamton,AEC,28,987,165,422,158,371,7,51,129,194,81,185,266,40,27,17,96,64,466
4248,Richard Roby,JR,2006-07,G,Colorado,Big 12,27,867,158,412,121,274,37,138,113,154,49,89,138,59,33,12,91,55,466
4249,Joey Rodriguez,JR,2009-10,G,Virginia Commonwealth,CAA,36,1184,157,361,100,198,57,163,95,118,28,69,97,208,67,0,98,60,466
4250,Brenton Scott,SO,2015-16,G,Indiana State,MVC,32,978,158,392,82,194,76,198,74,96,20,111,131,42,39,7,57,55,466
4251,Ryan Taylor,SO,2016-17,G,Evansville,MVC,33,1032,167,382,113,238,54,144,78,92,24,71,95,50,19,16,42,80,466
4252,Demond Watt,SR,2010-11,F,Texas A&M-Corpus Christi,Southland,31,1035,164,283,164,282,0,1,138,212,115,160,275,44,33,40,87,58,466
4253,James Williams,JR,2005-06,G,Long Island University,NEC,28,961,144,344,55,131,89,213,89,108,11,59,70,92,24,2,92,72,466
4256,Holland Woods,SO,2018-19,G,Portland State,Big Sky,31,1104,149,374,111,241,38,133,130,167,12,82,94,165,49,2,110,69,466
4257,Greer Wright,JR,2009-10,F,Binghamton,AEC,31,1034,152,350,111,216,41,134,121,161,48,139,187,98,37,18,116,105,466
4258,O.D. Anosike,JR,2011-12,F,Siena,MAAC,31,1142,184,351,184,351,0,0,97,172,135,253,388,33,35,31,75,79,465
4259,Brandon Ashley,JR,2014-15,F,Arizona,Pac-12,38,1055,166,323,154,287,12,36,121,172,69,128,197,25,23,25,55,107,465
4260,Brian Barbour,JR,2011-12,G,Columbia,Ivy,30,1068,141,358,104,247,37,111,146,162,16,67,83,133,30,3,69,46,465
4261,Connor Cashaw,JR,2017-18,G,Rice,CUSA,30,1008,158,397,107,237,51,160,98,135,42,172,214,96,40,2,65,60,465
4262,Hayden Dalton,JR,2016-17,F,Wyoming,MWC,38,1018,141,327,89,177,52,150,131,157,53,263,316,99,17,34,100,98,465
4263,Byron Davis,SR,2007-08,G,Youngstown State,Horizon,30,1063,175,388,131,252,44,136,71,103,28,62,90,71,33,6,86,69,465
4264,Justin Doellman,SR,2006-07,F,Xavier,A-10,34,919,164,331,122,215,42,116,95,120,48,140,188,57,30,39,56,106,465
4265,Arturo Dubois,SO,2005-06,F,Manhattan,MAAC,31,1002,197,352,197,352,0,0,71,135,99,166,265,31,39,74,65,119,465
4266,Junior Etou,SR,2017-18,F,Tulsa,AAC,31,942,145,311,103,191,42,120,133,186,77,167,244,47,16,8,72,66,465
4267,Montell Goodwin,SR,2017-18,G,Eastern Illinois,OVC,31,1100,164,411,91,208,73,203,64,83,15,89,104,103,34,12,61,46,465
4268,E.J. Gordon,SR,2005-06,G,Stetson,A-Sun,30,913,161,363,158,350,3,13,140,187,61,133,194,92,61,13,99,78,465
4269,Jerian Grant,JR,2012-13,G,Notre Dame,Big East,35,1270,156,384,104,233,52,151,101,137,12,89,101,194,44,8,100,62,465
4270,Jamie Harris,JR,2009-10,G,Drexel,CAA,32,1128,164,413,129,302,35,111,102,128,18,53,71,110,32,1,79,88,465
4271,Marcus Jackson,SO,2014-15,G,Rice,CUSA,32,1013,153,370,68,156,85,214,74,89,25,86,111,87,27,4,74,66,465
4272,Abdulai Jalloh,JR,2007-08,G,James Madison,CAA,30,874,139,342,84,200,55,142,132,166,39,126,165,87,50,11,125,102,465
4273,Curtis Jerrells,SO,2006-07,G,Baylor,Big 12,31,1019,157,356,100,200,57,156,94,139,35,112,147,118,33,11,85,52,465
4274,James Johnson,SO,2008-09,F,Wake Forest,ACC,31,946,187,345,165,276,22,69,69,99,79,185,264,62,44,48,74,91,465
4275,Kenny Kadji,SR,2012-13,F,Miami (FL),ACC,36,1047,168,357,121,223,47,134,82,124,56,188,244,30,14,46,63,87,465
4278,Codi Miller-McIntyre,JR,2014-15,G,Wake Forest,ACC,32,1007,167,371,148,304,19,67,112,174,27,126,153,137,32,11,80,57,465
4279,Tasmin Mitchell,SO,2006-07,F,Louisiana State,SEC,32,1092,173,371,132,262,41,109,78,104,60,129,189,59,34,25,55,76,465
4280,Amorrow Morgan,SR,2009-10,G,Idaho State,Big Sky,28,972,159,344,130,265,29,79,118,170,22,81,103,45,24,3,89,53,465
4281,DeMarcus Nelson,JR,2006-07,G,Duke,ACC,33,1052,174,364,130,243,44,121,73,123,45,132,177,66,44,17,82,76,465
4282,Brockeith Pane,SR,2011-12,G,Utah State,WAC,37,1194,164,405,135,309,29,96,108,139,14,97,111,159,27,7,107,88,465
4283,Charles Rhodes,JR,2006-07,F,Mississippi State,SEC,34,896,180,325,174,306,6,19,99,141,76,136,212,27,17,64,82,91,465
4284,Kassius Robertson,SO,2015-16,G,Canisius,MAAC,33,1121,153,350,67,137,86,213,73,100,34,59,93,59,36,2,77,73,465
4285,Parker Smith,JR,2011-12,G,North Florida,A-Sun,32,877,143,329,47,95,96,234,83,99,9,69,78,33,21,3,59,50,465
4286,Frankie Sullivan,SR,2012-13,G,Auburn,SEC,32,998,148,403,92,201,56,202,113,143,15,109,124,90,33,9,98,83,465
4287,Tony Taylor,JR,2010-11,G,George Washington,A-10,31,1034,149,353,109,235,40,118,127,183,17,85,102,144,40,1,81,71,465
4288,Torey Thomas,SR,2006-07,G,Holy Cross,Patriot,34,1279,131,349,83,230,48,119,155,201,22,139,161,160,95,0,135,92,465
4289,Killian Tillie,SO,2017-18,F,Gonzaga,WCC,36,944,181,312,136,218,45,94,58,75,61,151,212,60,30,37,57,88,465
4290,Mark Tyndale,JR,2006-07,G,Temple,A-10,24,821,164,304,140,248,24,56,113,159,50,110,160,68,37,11,65,58,465
4291,Gabe Vincent,SO,2015-16,G,UC-Santa Barbara,Big West,33,1055,163,401,83,193,80,208,59,73,20,86,106,74,41,6,57,93,465
4292,Mark Walters,SR,2005-06,G,New Mexico,MWC,30,974,154,353,97,202,57,151,100,142,31,104,135,92,62,10,78,86,465
4293,Maurice Watson Jr.,SO,2013-14,G,Boston University,Patriot,35,1090,189,382,161,299,28,83,59,94,20,106,126,248,74,0,101,87,465
4294,Rodney Williams,JR,2011-12,F,Minnesota,Big Ten,38,1213,185,328,168,273,17,55,78,132,62,150,212,66,50,54,59,103,465
4295,Raeford Worsham,SR,2015-16,G,Jackson State,SWAC,35,1109,173,336,170,316,3,20,116,196,104,165,269,75,61,28,77,98,465
4296,Daniel Amigo,JR,2016-17,C,Denver,Summit,30,748,182,340,173,324,9,16,91,139,50,163,213,41,8,18,80,107,464
4297,Andrew Andrews,JR,2014-15,G,Washington,Pac-12,31,1047,140,347,75,174,65,173,119,146,32,100,132,67,44,1,61,81,464
4300,Eddie Ard,JR,2006-07,G,Lipscomb,A-Sun,31,985,152,372,114,252,38,120,122,146,48,132,180,52,43,14,79,66,464
4301,Jamel Artis,SO,2014-15,F,Pittsburgh,ACC,34,1082,160,341,121,242,39,99,105,132,67,138,205,77,25,15,60,63,464
4302,Damen Bell-Holter,SO,2010-11,F,Oral Roberts,Summit,35,1065,160,313,147,279,13,34,131,180,96,178,274,51,19,50,65,90,464
4303,Anatoly Bose,SO,2008-09,G,Nicholls State,Southland,31,981,144,307,72,135,72,172,104,138,51,117,168,62,25,2,68,73,464
4304,Terrell Brown,SO,2018-19,G,Seattle,WAC,33,1101,180,396,166,352,14,44,90,132,47,179,226,150,36,9,79,89,464
4305,Mario Chalmers,SO,2006-07,G,Kansas,Big 12,38,1108,159,324,100,178,59,146,87,113,11,104,115,124,97,16,91,95,464
4306,Gary Clark,SR,2017-18,F,Cincinnati,AAC,36,1025,160,304,133,242,27,62,117,158,107,206,313,76,51,44,36,75,464
4307,D.J. Covington,JR,2012-13,F,Virginia Military Institute,Big South,31,905,190,339,189,332,1,7,83,128,93,131,224,26,39,93,64,93,464
4308,Chris De La Rosa,JR,2010-11,G,Maryland-Baltimore County,AEC,30,1074,167,422,129,303,38,119,92,130,20,98,118,181,30,0,85,60,464
4309,Angel Delgado,SR,2017-18,C,Seton Hall,Big East,34,1049,187,370,187,368,0,2,90,147,137,265,402,94,26,23,85,77,464
4310,Chris Devine,SR,2008-09,F,UC-Santa Barbara,Big West,30,908,163,316,157,284,6,32,132,171,68,128,196,43,32,11,91,69,464
4311,Justin Greene,SO,2009-10,F,Kent State,MAC,34,957,158,290,158,290,0,0,148,185,86,147,233,45,27,30,70,73,464
4312,Max Hazzard,JR,2018-19,G,UC-Irvine,Big West,37,976,159,386,66,146,93,240,53,68,17,57,74,76,25,1,47,48,464
4313,Lawrence Hill,SR,2008-09,F,Stanford,Pac-10,34,1059,182,362,161,297,21,65,79,114,68,131,199,76,31,17,57,71,464
4314,Jabarie Hinds,SR,2015-16,G,Massachusetts,A-10,32,947,176,383,128,253,48,130,64,87,14,61,75,96,47,7,54,67,464
4315,Justin Ingram,SR,2006-07,G,Toledo,MAC,32,1125,155,417,86,185,69,232,85,111,18,123,141,91,67,9,72,71,464
4316,Justin Johnson,JR,2016-17,F,Western Kentucky,CUSA,32,1005,173,331,147,264,26,67,92,166,83,219,302,66,11,18,42,45,464
4317,Sylven Landesberg,FR,2008-09,G,Virginia,ACC,28,957,150,344,134,293,16,51,148,186,47,122,169,78,28,3,77,49,464
4318,Amadi McKenzie,SR,2007-08,F,Tennessee Tech,OVC,32,963,178,301,170,276,8,25,100,173,103,165,268,55,30,9,79,89,464
4319,Daxter Miles,SR,2017-18,G,West Virginia,Big 12,36,1047,160,358,99,182,61,176,83,112,44,57,101,110,47,0,51,110,464
4320,Dwayne Mitchell,SR,2005-06,G,Louisiana,Sun Belt,28,1028,176,336,162,280,14,56,98,166,65,165,230,120,59,9,128,70,464
4321,John Mooney,JR,2018-19,F,Notre Dame,ACC,33,977,170,374,136,283,34,91,90,117,97,273,370,44,29,27,44,65,464
4322,Ashton Moore,JR,2013-14,G,Citadel,Southern,33,1070,150,386,80,216,70,170,94,120,16,95,111,120,33,3,82,64,464
4323,Grant Mullins,SR,2015-16,G,Columbia,Ivy,35,1090,141,301,72,144,69,157,113,136,17,115,132,116,28,5,46,80,464
4324,Derek Needham,SO,2010-11,G,Fairfield,MAAC,33,1161,150,420,77,184,73,236,91,130,14,85,99,150,47,1,128,89,464
4325,Nathan Peavy,SR,2006-07,F,Miami (OH),MAC,33,1122,165,312,140,243,25,69,109,149,46,163,209,31,24,39,61,97,464
4326,Jesse Pellot-Rosa,SR,2006-07,G,Virginia Commonwealth,CAA,35,925,152,339,86,184,66,155,94,117,71,87,158,48,39,15,55,78,464
4327,T.J. Price,JR,2013-14,G,Western Kentucky,Sun Belt,30,887,153,371,81,170,72,201,86,111,28,104,132,58,28,3,63,83,464
4328,Brandon Provost,SR,2012-13,G,Texas-Rio Grande Valley,GWC,31,1055,135,307,54,124,81,183,113,141,17,114,131,67,32,9,62,43,464
4329,Chasson Randle,SO,2012-13,G,Stanford,Pac-12,34,1054,156,391,95,221,61,170,91,116,23,77,100,89,38,2,78,99,464
4330,Alex Robinson,SR,2018-19,G,Texas Christian,Big 12,37,1290,169,394,131,272,38,122,88,135,14,129,143,254,52,12,129,84,464
4331,Nate Rohnert,SR,2009-10,G,Denver,Sun Belt,32,1045,141,285,116,208,25,77,157,211,25,157,182,123,39,5,78,79,464
4332,Josh Shipp,SO,2006-07,F,UCLA,Pac-10,35,1055,168,358,126,225,42,133,86,110,41,94,135,92,47,9,63,59,464
4333,Chris Smith,SR,2015-16,G,Utah State,MWC,31,960,161,326,98,186,63,140,79,106,43,120,163,64,25,12,50,66,464
4334,Delano Spencer,SR,2017-18,G,Tennessee State,OVC,30,984,152,348,67,147,85,201,75,90,17,76,93,38,34,2,55,56,464
4335,Jarvis Varnado,JR,2008-09,F,Mississippi State,SEC,36,1012,180,328,180,327,0,1,104,159,103,214,317,28,22,170,60,83,464
4336,Drew Viney,JR,2010-11,F,Loyola Marymount,WCC,27,910,167,349,129,248,38,101,92,120,37,140,177,48,23,26,78,71,464
4337,Kyle Washington,JR,2016-17,F,Cincinnati,AAC,36,889,184,361,169,319,15,42,81,114,78,165,243,31,13,42,54,91,464
4338,Mike Washington,JR,2008-09,F,Arkansas,SEC,30,901,178,323,173,293,5,30,103,171,105,189,294,27,29,39,62,92,464
4339,Devin Williams,JR,2015-16,F,West Virginia,Big 12,35,889,154,330,154,330,0,0,156,225,124,208,332,49,25,6,80,89,464
4342,Troy Williams,JR,2015-16,F,Indiana,Big Ten,35,916,163,318,137,243,26,75,112,162,50,154,204,70,39,28,93,76,464
4343,Chris Wright,SO,2008-09,F,Dayton,A-10,35,915,166,347,155,303,11,44,121,179,94,138,232,33,30,44,84,103,464
4344,Matt Bouldin,JR,2008-09,G,Gonzaga,WCC,34,1079,156,318,101,188,55,130,96,129,25,114,139,115,52,5,58,53,463
4345,Cane Broome,FR,2014-15,G,Sacred Heart,NEC,32,1011,165,371,120,238,45,133,88,117,15,107,122,77,36,6,75,63,463
4346,Michael Carrera,SR,2015-16,F,South Carolina,SEC,32,888,145,323,94,197,51,126,122,162,70,177,247,40,32,33,61,86,463
4347,Drew Eubanks,SO,2016-17,F,Oregon State,Pac-12,32,1027,182,310,182,310,0,0,99,139,81,185,266,39,20,69,96,92,463
4348,Chris Eversley,JR,2012-13,F,Cal Poly,Big West,30,986,173,383,152,315,21,68,96,133,75,135,210,61,21,4,55,59,463
4349,A.J. Graves,SR,2007-08,G,Butler,Horizon,34,1196,148,395,53,114,95,281,72,81,10,89,99,74,54,3,55,42,463
4350,Josh Hagins,SR,2015-16,G,Little Rock,Sun Belt,35,1073,162,358,105,209,57,149,82,98,28,119,147,165,52,6,59,75,463
4351,Stefhon Hannah,JR,2006-07,G,Missouri,Big 12,30,911,161,356,102,205,59,151,82,104,23,83,106,137,72,0,98,90,463
4352,Chris Harris,JR,2008-09,G,Navy,Patriot,30,1046,136,375,51,144,85,231,106,125,15,61,76,57,42,1,52,76,463
4353,Jace Hogan,JR,2017-18,F,Jacksonville,A-Sun,27,828,194,376,191,367,3,9,72,105,62,117,179,32,22,14,51,61,463
4354,Justinian Jessup,JR,2018-19,G,Boise State,MWC,33,1171,169,380,82,168,87,212,38,52,16,133,149,88,35,17,44,76,463
4355,Johnathon Jones,SO,2007-08,G,Oakland,Summit,31,1119,154,351,118,260,36,91,119,138,18,71,89,186,48,3,103,79,463
4356,Mason Jones,SO,2018-19,G,Arkansas,SEC,34,996,136,337,60,129,76,208,115,143,18,114,132,96,31,5,61,77,463
4357,Verdell Jones,SO,2009-10,G,Indiana,Big Ten,31,974,149,373,128,296,21,77,144,190,28,93,121,105,28,13,87,53,463
4358,Luke Kornet,SR,2016-17,F,Vanderbilt,SEC,35,1101,145,357,92,195,53,162,120,140,53,164,217,42,19,71,45,81,463
4359,David Laury,JR,2013-14,F,Iona,MAAC,33,957,162,295,162,295,0,0,139,237,75,199,274,77,22,38,60,101,463
4360,Damion Lee,SO,2012-13,G,Drexel,CAA,27,892,152,358,90,186,62,172,97,117,34,104,138,49,22,3,50,79,463
4361,Tony Lee,SR,2007-08,G,Robert Morris,NEC,34,989,176,347,151,267,25,80,86,124,84,141,225,217,95,5,147,78,463
4364,Matt Lewis,FR,2017-18,G,James Madison,CAA,32,1017,136,362,82,201,54,161,137,171,24,95,119,72,31,5,40,62,463
4365,Khyle Marshall,SR,2013-14,F,Butler,Big East,31,897,196,368,195,358,1,10,70,153,78,72,150,16,22,14,34,73,463
4366,Lawrence McKenzie,SR,2006-07,G,Minnesota,Big Ten,31,1071,157,377,79,170,78,207,71,92,12,92,104,86,16,5,97,58,463
4367,Morgan Means,JR,2018-19,G,Seattle,WAC,33,1166,143,364,81,196,62,168,115,135,22,121,143,98,41,1,80,114,463
4368,Juevol Myles,SR,2012-13,G,South Dakota,Summit,30,970,136,354,86,201,50,153,141,159,10,94,104,89,37,0,57,68,463
4369,Marshawn Powell,JR,2012-13,F,Arkansas,SEC,32,819,175,359,148,281,27,78,86,134,61,113,174,43,38,37,58,95,463
4370,Naz Reid,FR,2018-19,F,Louisiana State,SEC,34,926,171,365,143,281,28,84,93,128,86,159,245,29,25,23,85,108,463
4371,Adam Sollazzo,SR,2011-12,G,East Tennessee State,A-Sun,31,1083,154,359,141,315,13,44,142,215,50,119,169,137,51,4,97,72,463
4372,Daman Starring,SR,2012-13,G,UC-Irvine,Big West,36,1093,153,373,81,196,72,177,85,109,23,118,141,72,32,5,69,78,463
4373,Demontez Stitt,SR,2010-11,G,Clemson,ACC,32,1093,152,351,108,224,44,127,115,157,37,102,139,107,44,14,68,79,463
4374,Malik Story,SO,2010-11,G,Nevada,WAC,32,1030,158,400,82,203,76,197,71,97,17,78,95,63,19,3,77,53,463
4375,Jordan Swing,JR,2012-13,F,Alabama-Birmingham,CUSA,33,1008,162,347,101,177,61,170,78,99,40,151,191,90,43,13,61,81,463
4376,Ricky Tarrant,FR,2011-12,G,Tulane,CUSA,31,1026,140,329,88,178,52,151,131,167,14,97,111,102,52,1,68,80,463
4377,Marlain Veal,SO,2016-17,G,Southeastern Louisiana,Southland,32,937,155,325,109,210,46,115,107,142,27,94,121,144,58,2,119,74,463
4378,Zane Waterman,JR,2016-17,F,Manhattan,MAAC,32,888,151,313,111,203,40,110,121,155,62,161,223,20,24,14,66,96,463
4379,Christian Watford,SO,2010-11,F,Indiana,Big Ten,29,845,143,339,106,242,37,97,140,166,41,115,156,32,22,12,55,67,463
4380,Shayne Whittington,JR,2012-13,C,Western Michigan,MAC,35,1041,168,334,166,319,2,15,125,157,92,216,308,40,25,58,65,85,463
4381,Terrence Williams,SR,2008-09,F,Louisville,Big East,37,1266,169,392,112,244,57,148,68,117,51,266,317,185,86,29,86,62,463
4382,Jordan Aaron,JR,2012-13,G,Milwaukee,Horizon,32,1140,150,404,83,210,67,194,95,110,16,99,115,128,40,0,123,85,462
4383,Jo Acuil,SR,2017-18,F,Baylor,Big 12,33,1023,187,364,181,343,6,21,82,116,93,192,285,26,18,64,68,93,462
4386,Sean Baptiste,SO,2007-08,G,Fairleigh Dickinson,NEC,25,919,151,317,120,230,31,87,129,169,63,94,157,35,24,6,42,68,462
4387,Korvotney Barber,SR,2008-09,F,Auburn,SEC,36,1071,188,345,188,345,0,0,86,182,133,214,347,34,24,44,82,104,462
4388,Ryan Boatright,SO,2012-13,G,Connecticut,Big East,30,1089,151,352,108,223,43,129,117,149,13,75,88,131,44,2,89,44,462
4389,Ian Clark,FR,2009-10,G,Belmont,A-Sun,31,918,163,360,89,176,74,184,62,80,22,80,102,67,33,10,93,74,462
4390,Jason Clark,SR,2011-12,G,Georgetown,Big East,33,1077,159,334,111,185,48,149,96,128,30,104,134,58,54,9,75,66,462
4391,Markeith Cummings,JR,2011-12,F,Kennesaw State,A-Sun,30,1045,162,358,141,292,21,66,117,182,63,96,159,62,32,18,88,84,462
4392,Jackson Emery,SR,2010-11,G,Brigham Young,MWC,37,1202,151,354,59,99,92,255,68,82,15,116,131,97,101,8,35,98,462
4393,Darren Fells,SR,2007-08,C,UC-Irvine,Big West,32,1009,168,295,160,282,8,13,118,159,89,141,230,66,51,15,56,89,462
4394,Eric Ferguson,SO,2011-12,F,Georgia Southern,Southern,30,846,187,329,179,295,8,34,80,132,65,151,216,24,46,34,61,100,462
4395,Bruno Fernando,SO,2018-19,F,Maryland,Big Ten,34,1021,173,285,170,275,3,10,113,145,100,262,362,68,22,64,95,92,462
4396,Isaac Fotu,SO,2013-14,F,Hawaii,Big West,31,954,181,310,180,302,1,8,99,135,72,118,190,21,13,24,51,76,462
4397,Eric Garcia,SR,2016-17,G,Wofford,Southern,33,1111,129,288,53,120,76,168,128,139,9,82,91,226,24,1,60,66,462
4398,Trae Golden,SO,2011-12,G,Tennessee,SEC,34,1089,141,321,91,192,50,129,130,157,18,84,102,154,27,3,98,68,462
4399,David Gomez,SR,2007-08,F,Tulane,CUSA,32,911,162,301,153,279,9,22,129,179,55,142,197,29,27,51,65,88,462
4400,Jeremy Granger,SR,2011-12,G,Eastern Illinois,OVC,29,973,168,362,139,284,29,78,97,113,20,78,98,88,29,3,66,60,462
4401,Steven Gray,JR,2009-10,G,Gonzaga,WCC,34,1083,160,347,109,192,51,155,91,117,26,111,137,98,39,13,76,79,462
4402,Antoine Hood,SR,2005-06,G,Air Force,MWC,31,1127,171,315,134,219,37,96,83,113,30,85,115,86,47,7,65,62,462
4403,Cameron Jones,SR,2015-16,G,Radford,Big South,31,894,171,387,96,192,75,195,45,59,46,93,139,42,19,8,55,57,462
4404,DJ Laster,SR,2018-19,F,Gardner-Webb,Big South,34,896,192,348,169,292,23,56,55,84,68,116,184,15,14,21,52,80,462
4405,Romain Martin,JR,2008-09,G,Eastern Illinois,OVC,30,906,168,386,90,190,78,196,48,61,15,97,112,31,22,2,53,50,462
4408,Du'Vaughn Maxwell,SR,2013-14,F,Hampton,MEAC,31,965,176,346,171,325,5,21,105,205,74,153,227,44,36,92,57,94,462
4409,Koby McEwen,FR,2016-17,G,Utah State,MWC,32,989,137,297,79,159,58,138,130,179,15,144,159,96,24,11,85,90,462
4410,Brian Parker,SR,2018-19,G,Marist,MAAC,31,883,172,352,159,312,13,40,105,174,18,101,119,108,18,2,99,59,462
4411,Brian Parker,FR,2015-16,G,Marist,MAAC,29,913,163,317,153,291,10,26,126,174,46,104,150,84,20,1,90,63,462
4412,Robby Ptacek,JR,2010-11,G,Central Connecticut State,NEC,31,1043,156,382,122,274,34,108,116,131,21,97,118,51,33,2,81,69,462
4413,Justin Robinson,JR,2017-18,G,Virginia Tech,ACC,33,1021,150,323,99,195,51,128,111,142,24,68,92,185,41,2,83,76,462
4414,Dewayne Russell,FR,2012-13,G,Northern Arizona,Big Sky,32,1067,149,374,108,253,41,121,123,168,15,63,78,102,49,4,98,65,462
4415,Dantrell Thomas,SR,2013-14,G,Nicholls State,Southland,29,838,150,286,136,249,14,37,148,194,49,109,158,78,44,11,55,92,462
4416,Marcus Walker,SR,2008-09,G,Colorado State,MWC,27,868,163,397,111,245,52,152,84,107,17,53,70,58,29,1,61,64,462
4417,Karrington Ward,JR,2013-14,F,Eastern Michigan,MAC,37,1083,151,343,94,192,57,151,103,159,47,188,235,28,52,25,44,48,462
4418,Jalen Adams,SO,2016-17,G,Connecticut,AAC,32,1137,174,404,138,301,36,103,77,93,23,113,136,195,35,7,99,68,461
4419,Cameron Ayers,SR,2013-14,G,Bucknell,Patriot,30,1022,154,374,92,222,62,152,91,106,25,109,134,41,27,2,39,40,461
4420,Will Blalock,JR,2005-06,G,Iowa State,Big 12,30,1072,177,396,130,278,47,118,60,91,24,75,99,184,65,2,89,55,461
4421,Andrew Brown,JR,2007-08,G,Lafayette,Patriot,29,837,147,352,48,105,99,247,68,82,14,53,67,85,28,1,79,68,461
4422,Robert Brown,SR,2015-16,G,Alabama-Birmingham,CUSA,33,999,160,372,93,202,67,170,74,96,11,79,90,102,30,9,58,57,461
4423,Brenton Butler,SR,2009-10,G,Fordham,A-10,28,961,143,427,85,233,58,194,117,144,14,74,88,68,25,0,62,57,461
4424,Bryce Canda,SR,2017-18,G,Portland State,Big Sky,33,1134,171,425,96,193,75,232,44,67,46,151,197,82,55,6,51,34,461
4425,Jeremy Combs,SO,2015-16,F,North Texas,CUSA,31,981,175,291,175,291,0,0,111,190,107,218,325,24,42,23,61,93,461
4426,Tyrone Conley,SR,2010-11,G,New Hampshire,AEC,30,1049,158,415,80,178,78,237,67,97,35,66,101,63,38,23,62,80,461
4427,Rasheem Dunn,SO,2017-18,G,St. Francis (NY),NEC,30,928,157,403,115,253,42,150,105,136,21,151,172,70,42,1,62,60,461
4428,Chris Fouch,SO,2010-11,G,Drexel,CAA,31,884,155,409,93,223,62,186,89,126,25,79,104,38,15,5,41,57,461
4429,Grandy Glaze,SR,2015-16,F,Grand Canyon,WAC,33,872,198,332,198,321,0,11,65,106,76,214,290,26,18,0,52,51,461
4430,Martez Harrison,JR,2015-16,G,Missouri-Kansas City,WAC,30,999,134,346,95,220,39,126,154,201,25,86,111,126,38,3,110,76,461
4431,Jalin Hart,JR,2016-17,G,Incarnate Word,Southland,29,958,163,315,126,221,37,94,98,153,16,86,102,135,40,8,77,78,461
4432,Spencer Hawes,FR,2006-07,C,Washington,Pac-10,31,896,193,363,192,360,1,3,74,98,61,136,197,60,16,54,78,70,461
4433,Isaiah Hicks,SR,2016-17,F,North Carolina,ACC,39,907,174,302,174,302,0,0,113,145,72,141,213,55,16,29,64,119,461
4434,Ken Horton,SO,2008-09,F,Central Connecticut State,NEC,28,954,168,334,136,244,32,90,93,116,61,100,161,41,16,44,56,45,461
4435,Twymond Howard,JR,2014-15,F,Tennessee-Martin,OVC,34,1182,167,351,146,290,21,61,106,148,62,161,223,58,29,20,61,85,461
4436,Alshwan Hymes,JR,2011-12,G,Canisius,MAAC,30,1061,168,431,84,174,84,257,41,56,27,70,97,51,36,2,80,64,461
4437,Kerron Johnson,SR,2012-13,G,Belmont,OVC,33,991,137,299,121,243,16,56,171,220,11,93,104,158,57,1,104,85,461
4438,Ravern Johnson,JR,2009-10,G,Mississippi State,SEC,35,1010,173,362,86,148,87,214,28,43,26,94,120,23,14,16,44,46,461
4439,Tyus Jones,FR,2014-15,G,Duke,ACC,39,1322,135,324,88,200,47,124,144,162,19,118,137,217,59,3,76,46,461
4440,Jackson Kent,SR,2016-17,G,James Madison,CAA,33,1189,153,343,99,190,54,153,101,119,16,130,146,75,37,4,59,46,461
4441,George King,SO,2015-16,G,Colorado,Pac-12,34,862,152,341,84,192,68,149,89,119,55,104,159,23,13,8,63,60,461
4442,Chris Knight,SO,2018-19,F,Dartmouth,Ivy,30,845,192,385,184,357,8,28,69,112,64,139,203,71,18,37,90,90,461
4443,Matthew Knight,SR,2006-07,F,Loyola Marymount,WCC,28,912,173,358,172,353,1,5,114,166,72,143,215,30,31,11,40,56,461
4444,Keon Lewis,SR,2014-15,G,Texas-San Antonio,CUSA,29,974,133,336,97,231,36,105,159,193,19,59,78,89,47,0,62,57,461
4445,Tyrone Lewis,SR,2009-10,G,Niagara,MAAC,27,923,144,373,57,136,87,237,86,114,39,87,126,46,51,19,38,72,461
4446,Anthony Livingston,SO,2014-15,F,Arkansas State,Sun Belt,29,1039,166,358,139,274,27,84,102,148,77,214,291,22,14,29,78,67,461
4447,Marin Maric,SR,2016-17,C,Northern Illinois,MAC,32,911,172,303,167,281,5,22,112,168,101,167,268,25,23,17,73,89,461
4450,Anthony Mathis,SR,2018-19,G,New Mexico,MWC,32,986,134,326,28,71,106,255,87,98,14,57,71,66,34,5,61,80,461
4451,Trhae Mitchell,JR,2018-19,F,South Alabama,Sun Belt,34,1164,175,366,141,285,34,81,77,119,46,211,257,122,39,71,82,94,461
4452,Shaquille Morris,SR,2017-18,C,Wichita State,AAC,33,783,176,318,158,272,18,46,91,125,55,130,185,44,18,51,48,79,461
4453,Le'Bryan Nash,SO,2012-13,G,Oklahoma State,Big 12,33,1052,160,346,148,296,12,50,129,174,28,107,135,59,20,5,86,88,461
4454,Donte Poole,SR,2011-12,F,Murray State,OVC,33,1024,139,315,71,134,68,181,115,134,21,98,119,48,63,5,61,73,461
4455,R.J. Price,JR,2013-14,G,Radford,Big South,35,1033,151,382,74,171,77,211,82,101,14,73,87,100,49,4,48,49,461
4456,Rodney Purvis,JR,2015-16,G,Connecticut,AAC,36,1038,163,376,93,194,70,182,65,99,16,91,107,74,32,4,55,71,461
4457,Ronald Roberts ,SR,2013-14,F,Saint Joseph's,A-10,32,1065,174,290,174,290,0,0,113,190,92,146,238,41,11,43,63,78,461
4458,T.J. Robinson,JR,2010-11,F,Long Beach State,Big West,34,1114,182,364,173,340,9,24,88,150,100,244,344,33,19,3,78,79,461
4459,Jaelan Sanford,SO,2016-17,G,Toledo,MAC,34,1219,157,345,92,179,65,166,82,113,14,59,73,107,23,17,63,61,461
4460,Matt Scott,SO,2015-16,G,Niagara,MAAC,30,992,146,358,112,240,34,118,135,176,61,152,213,76,39,10,96,85,461
4461,Mike Scott,SR,2007-08,F,Kent State,MAC,35,1153,148,305,108,204,40,101,125,147,64,158,222,39,39,27,51,66,461
4462,Tyler Seibring,SO,2016-17,F,Elon,CAA,32,1044,169,359,109,207,60,152,63,85,54,167,221,61,16,27,46,60,461
4463,E.J. Singler,JR,2011-12,F,Oregon,Pac-12,34,1046,151,323,102,190,49,133,110,121,43,146,189,76,20,14,64,89,461
4464,Tyler Smith,FR,2006-07,F,Iowa,Big Ten,31,1045,174,394,157,327,17,67,96,132,67,86,153,111,45,8,92,79,461
4465,Moses Sonko,SR,2006-07,G,Coastal Carolina,Big South,30,845,188,336,182,319,6,17,79,106,82,126,208,32,43,4,63,86,461
4466,Bo Spencer,SR,2011-12,G,Nebraska,Big Ten,30,976,153,373,90,188,63,185,92,105,9,68,77,98,39,4,89,62,461
4467,Bo Taylor,SR,2006-07,F,Hartford,AEC,31,971,171,355,159,304,12,51,107,159,34,130,164,55,51,8,76,117,461
4468,Ryan Taylor,SR,2016-17,F,Marshall,CUSA,32,921,160,315,141,247,19,68,122,190,66,202,268,73,26,53,77,111,461
4469,Jalin Thomas,SR,2010-11,G,Central Michigan,MAC,29,975,139,365,80,198,59,167,124,154,58,95,153,15,17,0,51,64,461
4472,Kahlil Thomas,SR,2016-17,F,Rider,MAAC,33,1012,179,339,173,319,6,20,97,150,84,207,291,40,34,29,76,96,461
4473,Ralston Turner,SR,2014-15,G,North Carolina State,ACC,36,1136,150,381,56,125,94,256,67,80,22,95,117,35,22,6,37,86,461
4474,Gavin Ware,SR,2015-16,F,Mississippi State,SEC,30,842,183,298,183,297,0,1,95,126,87,147,234,27,28,32,55,83,461
4475,Tyler Wilkerson,SR,2009-10,F,Marshall,CUSA,33,867,169,326,154,280,15,46,108,140,77,161,238,34,21,34,52,87,461
4476,Leon Williams,JR,2006-07,F,Ohio,MAC,32,927,162,278,162,278,0,0,137,201,114,169,283,29,33,24,61,121,461
4477,Josh Young,SR,2009-10,G,Drake,MVC,32,1100,146,332,93,184,53,148,116,159,26,100,126,86,33,1,57,79,461
4478,Shaddean Aaron,JR,2006-07,G,Mercer,A-Sun,29,981,173,356,150,277,23,79,91,118,,,177,56,38,36,,,460
4479,Stefan Blaszczynski,SR,2006-07,G,Nicholls State,Southland,24,859,149,327,108,210,41,117,121,155,60,108,168,77,31,6,74,75,460
4480,Ryan Bright,JR,2006-07,F,Sam Houston State,Southland,31,909,171,333,135,239,36,94,82,153,81,169,250,87,54,45,85,87,460
4481,Alec Brown,SR,2013-14,F,Green Bay,Horizon,30,909,165,347,123,247,42,100,88,121,63,108,171,30,15,94,65,67,460
4482,John Brown,FR,2012-13,F,High Point,Big South,28,724,180,347,180,347,0,0,100,151,84,87,171,19,48,34,37,72,460
4483,Stanley Burrell,SO,2005-06,G,Xavier,A-10,32,1093,165,400,96,228,69,172,61,78,21,73,94,105,23,3,73,56,460
4484,Olin Carter III,SR,2018-19,G,San Diego,WCC,31,1050,170,387,89,171,81,216,39,49,6,85,91,49,26,5,46,84,460
4485,Quinton Chievous,SR,2015-16,G,Hampton,MEAC,27,922,185,325,167,266,18,59,72,149,86,204,290,54,16,4,72,63,460
4486,Aaron Cook,SR,2005-06,G,Hartford,AEC,28,978,153,365,71,155,82,210,72,94,35,82,117,69,45,3,60,59,460
4487,Javaris Crittenton,FR,2006-07,G,Georgia Tech,ACC,32,1003,158,351,122,250,36,101,108,138,28,91,119,184,65,2,124,67,460
4488,Chris Davis,SR,2008-09,G,Southern,SWAC,31,1018,152,372,100,239,52,133,104,136,28,105,133,97,35,8,76,55,460
4489,Marcus Derrickson,JR,2017-18,F,Georgetown,Big East,29,927,150,297,103,196,47,101,113,131,67,167,234,46,20,19,63,70,460
4490,Zabian Dowdell,JR,2005-06,G,Virginia Tech,ACC,30,1079,164,393,110,242,54,151,78,112,13,81,94,103,70,5,70,65,460
4491,Colin Falls,SR,2006-07,G,Notre Dame,Big East,30,1027,138,314,39,64,99,250,85,102,10,75,85,72,32,5,42,67,460
4494,Dylan Garrity,SR,2014-15,G,Sacramento State,Big Sky,33,1085,148,319,67,121,81,198,83,100,8,59,67,84,32,1,55,54,460
4495,Dairese Gary,JR,2009-10,G,New Mexico,MWC,35,1002,125,278,110,234,15,44,195,260,16,81,97,137,36,1,63,70,460
4496,Evan Gordon,SO,2010-11,G,Liberty,Big South,32,1053,155,400,85,192,70,208,80,105,24,69,93,70,52,4,87,66,460
4497,Cedric Hankerson,SO,2014-15,G,Boston University,Patriot,29,982,121,305,49,124,72,181,146,217,21,110,131,76,52,3,78,85,460
4498,Bobby Howard,SR,2010-11,F,Montana State,Big Sky,31,993,159,403,112,248,47,155,95,154,67,156,223,54,27,9,60,83,460
4499,Loren Jackson,SO,2018-19,G,Akron,MAC,33,1042,137,397,71,177,66,220,120,149,26,67,93,102,30,5,60,65,460
4500,Emmanuel Jones,SR,2008-09,F,Texas-Rio Grande Valley,Ind,26,791,185,332,184,328,1,4,89,135,65,142,207,28,20,23,66,49,460
4501,Mike Lewis II,SO,2017-18,G,Duquesne,A-10,32,994,138,359,49,117,89,242,95,115,16,58,74,23,34,1,41,66,460
4502,Chavaughn Lewis,FR,2011-12,G,Marist,MAAC,32,943,150,347,124,268,26,79,134,208,36,113,149,57,53,25,95,74,460
4503,Trenton Marshall,JR,2009-10,F,Jacksonville State,OVC,26,817,154,370,97,215,57,155,95,120,32,105,137,62,44,14,52,60,460
4504,Mark McAndrew,JR,2006-07,G,Brown,Ivy,29,1056,127,274,55,111,72,163,134,158,28,127,155,64,28,1,80,74,460
4505,Dexter McClanahan,SO,2016-17,G,Savannah State,MEAC,28,780,152,349,79,142,73,207,83,120,20,134,154,62,30,4,63,46,460
4506,Sheldon McClellan,SO,2012-13,G,Texas,Big 12,34,929,136,356,103,235,33,121,155,186,36,96,132,29,28,3,57,28,460
4507,Chris McEachin,SR,2011-12,G,Norfolk State,MEAC,36,1077,154,395,78,174,76,221,76,102,26,79,105,42,45,20,72,90,460
4508,Tyrus McGee,SR,2012-13,G,Iowa State,Big 12,35,841,157,322,61,115,96,207,50,61,31,92,123,46,40,11,30,63,460
4509,Jordan McLaughlin,SR,2017-18,G,Southern California,Pac-12,36,1270,159,354,105,218,54,136,88,118,26,106,132,281,72,8,92,39,460
4510,Akil Mitchell,JR,2012-13,F,Virginia,ACC,35,1069,177,325,177,323,0,2,106,153,94,218,312,52,45,14,63,74,460
4511,Jonathan Mitchell,SR,2010-11,F,Rutgers,Big East,32,969,164,365,113,235,51,130,81,103,57,121,178,29,26,19,49,51,460
4512,Devin Morgan Jr.,SO,2016-17,G,Delaware State,MEAC,32,1148,149,404,63,165,86,239,76,85,16,82,98,103,35,0,57,42,460
4513,Robert Nyakundi,SR,2011-12,F,Southern Methodist,CUSA,31,1034,156,337,72,134,84,203,64,82,34,116,150,30,35,9,58,90,460
4516,Femi Olujobi,SR,2018-19,F,DePaul,Big East,36,954,163,271,149,238,14,33,120,172,71,125,196,35,20,11,66,87,460
4517,Isaiah Philmore,SO,2010-11,F,Towson,CAA,30,1071,169,344,151,293,18,51,104,131,75,135,210,30,27,17,60,79,460
4518,John Roberson,SO,2008-09,G,Texas Tech,Big 12,33,1160,146,385,75,184,71,201,97,117,12,104,116,212,35,2,116,83,460
4519,Adrian Rodgers,SO,2014-15,G,Southern,SWAC,35,1010,164,420,110,254,54,166,78,98,24,122,146,40,26,5,64,67,460
4520,Mike Rose,JR,2007-08,G,Eastern Kentucky,OVC,30,1086,167,399,107,224,60,175,66,81,48,84,132,65,54,6,70,37,460
4521,Joe Rosga,SO,2016-17,G,Denver,Summit,30,1034,152,334,78,167,74,167,82,96,14,108,122,97,34,1,65,62,460
4522,Dylan Smith,FR,2015-16,G,North Carolina-Asheville,Big South,34,929,134,363,53,131,81,232,111,135,13,77,90,63,34,11,88,81,460
4523,Marcus Stout,JR,2006-07,G,Fordham,A-10,30,988,157,368,83,172,74,196,72,109,19,76,95,78,49,4,61,66,460
4524,Thomas Walkup,SO,2013-14,G,Stephen F. Austin,Southland,35,994,175,308,161,269,14,39,96,131,81,105,186,75,38,9,55,111,460
4525,Rich Williams,JR,2015-16,G,Manhattan,MAAC,31,879,166,367,128,262,38,105,90,113,45,140,185,41,33,15,74,82,460
4526,Ryan Allen,FR,2017-18,G,Delaware,CAA,30,1072,163,401,77,180,86,221,47,65,8,67,75,45,15,6,49,86,459
4527,Corey Allmond,JR,2008-09,G,Sam Houston State,Southland,30,922,155,354,56,127,99,227,50,61,15,62,77,79,39,0,56,57,459
4528,Daniel Amigo,SR,2017-18,C,Denver,Summit,30,774,189,363,171,319,18,44,63,106,67,133,200,47,9,22,89,96,459
4529,Jaylen Barford,JR,2016-17,G,Arkansas,SEC,36,913,174,397,145,288,29,109,82,109,39,97,136,72,44,6,70,81,459
4530,Chris Boucher,JR,2015-16,F,Oregon,Pac-12,38,981,159,295,120,180,39,115,102,149,103,177,280,15,30,110,43,102,459
4531,Ron Curry,JR,2014-15,G,James Madison,CAA,33,1175,141,349,79,202,62,147,115,156,19,108,127,143,36,7,75,60,459
4532,Josh Duncan,SR,2007-08,F,Xavier,A-10,37,829,141,284,86,152,55,132,122,143,43,130,173,49,16,23,61,90,459
4533,Chris Eversley,SR,2013-14,F,Cal Poly,Big West,34,1057,167,417,125,273,42,144,83,117,74,167,241,55,44,13,46,72,459
4534,Iverson Fleming,SR,2016-17,G,Long Island University,NEC,32,1009,154,406,104,265,50,141,101,131,26,81,107,61,45,13,92,86,459
4535,Jacob Grandison,SO,2018-19,G,Holy Cross,Patriot,33,1141,169,394,100,205,69,189,52,65,26,138,164,97,36,11,62,72,459
4536,Rokas Gustys,SO,2015-16,F,Hofstra,CAA,34,1033,192,291,192,291,0,0,75,172,141,301,442,31,32,40,60,114,459
4537,Ahmed Hill,SR,2018-19,G,Virginia Tech,ACC,35,1236,164,370,89,178,75,192,56,69,23,112,135,46,28,2,47,69,459
4538,Rick Jackson,SR,2010-11,F,Syracuse,Big East,35,1245,193,328,193,328,0,0,73,137,120,240,360,77,47,86,72,71,459
4539,Matt Janning,JR,2008-09,G,Northeastern,CAA,32,1151,158,389,107,231,51,158,92,124,32,118,150,85,48,6,78,64,459
4540,Joseph Jones,SO,2005-06,C,Texas A&M,Big 12,30,869,155,305,153,286,2,19,147,200,67,128,195,45,46,16,56,90,459
4541,Tim Kempton,SO,2014-15,C,Lehigh,Patriot,30,866,172,345,171,344,1,1,114,160,56,204,260,31,15,11,76,79,459
4542,Bronson Koenig,JR,2015-16,G,Wisconsin,Big Ten,35,1222,151,385,68,172,83,213,74,97,13,84,97,84,14,6,52,76,459
4543,Marvett McDonald,SR,2005-06,G,Alabama-Birmingham,CUSA,31,893,156,402,60,136,96,266,51,64,19,60,79,70,44,1,50,61,459
4544,Carlos Medlock,JR,2007-08,G,Eastern Michigan,MAC,31,1005,126,322,63,136,63,186,144,176,21,81,102,127,34,1,108,79,459
4545,Donavan Monroe,SR,2010-11,G,College of Charleston,Southern,37,1225,160,354,118,227,42,127,97,132,26,75,101,97,33,5,77,73,459
4546,Marcus Morris,SO,2009-10,F,Kansas,Big 12,36,889,174,305,162,273,12,32,99,150,96,124,220,37,34,12,48,94,459
4547,Jordan Price,SR,2016-17,G,La Salle,A-10,30,985,155,358,86,163,69,195,80,105,17,112,129,77,19,8,71,59,459
4548,Taurean Prince,JR,2014-15,F,Baylor,Big 12,33,868,167,354,107,202,60,152,65,101,60,124,184,42,49,29,67,70,459
4549,Jason Richards,JR,2006-07,G,Davidson,Southern,34,1167,145,349,92,208,53,141,116,143,25,105,130,249,52,2,106,59,459
4550,Grant Riller,FR,2016-17,G,College of Charleston,CAA,35,944,159,327,121,213,38,114,103,129,13,59,72,43,33,7,47,60,459
4551,Sam Rowley,SR,2014-15,F,Albany (NY),AEC,33,1094,168,332,168,328,0,4,123,150,81,170,251,59,40,26,88,90,459
4552,Darius Roy,JR,2018-19,G,Milwaukee,Horizon,29,1015,164,365,119,254,45,111,86,102,13,105,118,118,36,7,93,75,459
4553,Dana Smith,JR,2008-09,F,Longwood,Ind,31,931,173,334,159,281,14,53,99,152,71,128,199,65,54,26,69,107,459
4554,Jonathan Tavernari,SO,2007-08,F,Brigham Young,MWC,35,966,166,420,78,186,88,234,39,45,34,150,184,53,48,16,59,70,459
4555,Edwin Ubiles,SR,2009-10,F,Siena,MAAC,30,926,188,398,159,325,29,73,54,82,31,80,111,67,33,7,58,38,459
4558,Deron Washington,SR,2007-08,F,Virginia Tech,ACC,35,1159,147,353,129,286,18,67,147,219,69,158,227,80,34,22,74,103,459
4559,Arnaud William Adala Moto,JR,2015-16,F,Towson,CAA,33,935,145,329,128,271,17,58,151,208,75,199,274,53,25,4,94,87,458
4560,Ryan Anderson,JR,2013-14,F,Boston College,ACC,32,1004,149,305,145,290,4,15,156,211,76,156,232,45,25,20,62,65,458
4561,Kelsey Barlow,SR,2013-14,G,Illinois-Chicago,Horizon,31,973,150,388,102,238,48,150,110,144,30,124,154,121,31,8,81,83,458
4562,George Blagojevic,SR,2018-19,F,Hartford,AEC,32,1071,185,329,179,300,6,29,82,142,84,157,241,61,39,28,84,87,458
4563,Kellen Brand,JR,2008-09,G,Appalachian State,Southern,31,944,154,315,106,193,48,122,102,129,28,54,82,45,24,0,63,67,458
4564,Michael Bryson,JR,2014-15,G,UC-Santa Barbara,Big West,33,1060,160,360,92,171,68,189,70,82,33,125,158,56,27,22,51,82,458
4565,Ricky Cadell,SO,2008-09,G,St. Francis (NY),NEC,30,924,152,326,96,186,56,140,98,140,26,75,101,76,31,0,103,81,458
4566,Eli Cain,SR,2018-19,G,DePaul,Big East,35,1189,158,373,97,205,61,168,81,118,12,97,109,119,42,10,82,97,458
4567,Olin Carter III,SO,2016-17,G,San Diego,WCC,30,1063,151,366,59,124,92,242,64,82,5,70,75,61,19,1,43,75,458
4568,Keith Clanton,SR,2012-13,F,Central Florida,CUSA,31,1096,167,312,156,256,11,56,113,177,90,173,263,77,35,63,96,83,458
4569,Jack Cooley,SR,2012-13,F,Notre Dame,Big East,35,1026,173,299,172,297,1,2,111,158,141,213,354,29,23,41,50,93,458
4570,Darryl Crawford,SR,2009-10,G,Manhattan,MAAC,31,1033,157,380,136,304,21,76,123,165,56,140,196,69,36,14,67,69,458
4571,Corey Davis Jr.,JR,2017-18,G,Houston,AAC,35,1057,148,334,45,94,103,240,59,73,23,84,107,84,31,1,50,69,458
4572,Torin Dorn,JR,2017-18,G,North Carolina State,ACC,33,948,178,335,155,261,23,74,79,108,80,128,208,46,33,13,66,78,458
4573,Aaron Gray,JR,2005-06,C,Pittsburgh,Big East,33,920,170,323,170,323,0,0,118,186,121,224,345,60,21,49,88,86,458
4574,J.J. Hickson,FR,2007-08,F,North Carolina State,ACC,31,890,163,276,163,275,0,1,132,195,80,182,262,31,22,47,83,60,458
4575,Kadeem Jack,JR,2013-14,F,Rutgers,AAC,32,938,175,349,173,346,2,3,106,154,87,132,219,23,23,41,60,92,458
4576,Quan Jackson,SO,2018-19,G,Georgia Southern,Sun Belt,31,992,158,358,111,216,47,142,95,129,14,126,140,45,62,16,57,60,458
4577,Vander Joaquim,JR,2011-12,C,Hawaii,WAC,32,978,172,307,172,307,0,0,114,180,100,204,304,33,21,58,65,98,458
4580,Damian Jones,JR,2015-16,C,Vanderbilt,SEC,33,866,184,312,184,309,0,3,90,168,74,153,227,38,8,54,65,108,458
4581,Coby Karl,SR,2006-07,G,Boise State,WAC,31,1009,131,321,51,105,80,216,116,139,16,111,127,125,25,18,97,76,458
4582,Markus Kennedy,SO,2013-14,F,Southern Methodist,AAC,37,924,182,341,181,336,1,5,93,158,73,188,261,58,57,44,67,87,458
4583,Travis Leslie,SO,2009-10,G,Georgia,SEC,31,912,169,347,163,336,6,11,114,155,96,116,212,78,40,30,82,65,458
4584,Kira Lewis Jr.,FR,2018-19,G,Alabama,SEC,34,1075,157,363,103,212,54,151,90,115,13,74,87,98,28,10,74,61,458
4585,Mike Liabo,SO,2011-12,G,Tennessee-Martin,OVC,30,946,156,448,88,225,68,223,78,97,20,100,120,79,17,4,85,48,458
4586,Alex Loughton,SR,2005-06,C,Old Dominion,CAA,34,970,162,334,149,294,13,40,121,162,85,177,262,46,34,23,57,90,458
4587,Charles Mann,SO,2013-14,G,Georgia,SEC,33,979,121,295,100,227,21,68,195,277,23,115,138,97,35,2,113,82,458
4588,Jordan Mathews,JR,2015-16,G,University of California,Pac-12,34,1011,143,339,54,125,89,214,83,104,25,89,114,42,16,0,45,73,458
4589,Gerald McLemore,SR,2011-12,G,Maine,AEC,27,956,162,378,89,194,73,184,61,66,17,47,64,36,21,5,47,39,458
4590,Paul Miller,SR,2005-06,C,Wichita State,MVC,35,979,174,340,174,338,0,2,110,149,74,158,232,41,15,15,63,85,458
4591,Robert Mitchell,FR,2006-07,F,Duquesne,A-10,28,750,172,381,128,271,44,110,70,96,64,87,151,40,22,18,51,68,458
4592,Siler Schneider,JR,2017-18,G,UC-Davis,Big West,33,995,176,397,140,285,36,112,70,98,16,86,102,71,37,8,82,85,458
4593,Kendall Smith,SR,2017-18,G,Oklahoma State,Big 12,35,943,166,414,116,292,50,122,76,114,20,88,108,100,35,1,75,61,458
4594,Jae'Sean Tate,JR,2016-17,F,Ohio State,Big Ten,32,1021,182,333,174,297,8,36,86,150,62,143,205,64,34,15,72,101,458
4595,Moritz Wagner,SO,2016-17,F,Michigan,Big Ten,38,908,168,300,123,186,45,114,77,106,51,107,158,20,39,14,54,102,458
4596,C.J. Watson,SR,2005-06,G,Tennessee,SEC,30,956,136,291,87,175,49,116,137,156,16,77,93,117,59,4,63,77,458
4597,Devonta White,JR,2012-13,G,Georgia State,CAA,31,1121,155,361,115,233,40,128,108,146,20,66,86,121,52,1,93,54,458
4598,Sam Willard,SR,2010-11,F,Pacific,Big West,31,1030,165,344,142,278,23,66,105,134,93,233,326,49,20,22,67,85,458
4599,Eric Williams Jr.,FR,2017-18,G,Duquesne,A-10,32,1079,147,375,80,191,67,184,97,131,68,212,280,51,43,10,67,75,458
4602,E.J. Anosike,SO,2018-19,F,Sacred Heart,NEC,32,928,156,301,137,248,19,53,126,166,105,153,258,29,19,15,48,79,457
4603,Chip Armelin,JR,2014-15,G,Southern Mississippi,CUSA,29,1022,170,364,109,195,61,169,56,88,37,83,120,56,33,6,57,42,457
4604,Art Bernardi,SR,2012-13,F,Houston Baptist,GWC,31,921,178,384,164,346,14,38,87,132,67,150,217,40,37,27,82,85,457
4605,Mike Black,JR,2011-12,G,Albany (NY),AEC,34,1121,156,350,105,207,51,143,94,125,22,74,96,145,38,0,89,79,457
4606,Ramel Bradley,JR,2006-07,G,Kentucky,SEC,34,1107,141,336,72,148,69,188,106,130,31,96,127,129,44,9,91,71,457
4607,Chris Braswell,JR,2011-12,F,Charlotte,A-10,29,863,162,317,147,268,15,49,118,152,73,147,220,34,35,36,90,93,457
4608,Brandon Childress,JR,2018-19,G,Wake Forest,ACC,31,1128,131,342,57,141,74,201,121,152,13,104,117,125,48,1,84,73,457
4609,Geary Claxton,SO,2005-06,F,Penn State,Big Ten,30,1025,168,383,146,315,22,68,99,157,96,129,225,45,42,21,63,82,457
4610,Charles Cooke,SR,2016-17,G,Dayton,A-10,29,915,151,332,102,209,49,123,106,151,29,120,149,82,32,28,61,56,457
4611,Bryce Cotton,SO,2011-12,G,Providence,Big East,32,1234,145,351,68,148,77,203,90,101,14,67,81,72,32,5,52,51,457
4612,Dave Dudzinski,JR,2012-13,F,Holy Cross,Patriot,30,869,166,344,148,292,18,52,107,131,69,130,199,25,18,26,45,81,457
4613,Khallid Hart,FR,2013-14,G,Marist,MAAC,31,1068,149,326,104,208,45,118,114,144,19,74,93,78,43,0,75,73,457
4614,LaDontae Henton,FR,2011-12,F,Providence,Big East,32,1191,168,370,124,258,44,112,77,109,88,186,274,36,32,34,55,76,457
4615,Jaleel Hogan,JR,2016-17,F,Detroit Mercy,Horizon,30,792,175,296,175,296,0,0,107,199,84,91,175,31,16,31,68,113,457
4616,Richaun Holmes,SR,2014-15,F,Bowling Green State,MAC,31,892,165,293,147,250,18,43,109,153,88,160,248,26,22,83,60,77,457
4617,Damon Huffman,SR,2007-08,G,Brown,Ivy,29,1002,154,319,72,137,82,182,67,84,13,77,90,48,35,2,45,50,457
4618,Isaiah Hunter,SR,2005-06,G,Old Dominion,CAA,32,903,148,379,91,207,57,172,104,138,21,85,106,85,23,4,78,35,457
4619,Andre Ingram,SR,2006-07,G,American,Patriot,30,1035,150,357,72,173,78,184,79,95,22,121,143,53,37,2,39,52,457
4620,Paul Jackson,SR,2018-19,G,Eastern Michigan,MAC,32,1118,165,440,144,349,21,91,106,149,16,48,64,148,42,1,88,89,457
4621,Jeremy Lamb,FR,2010-11,G,Connecticut,Big East,41,1140,182,374,136,249,46,125,47,59,50,133,183,66,35,25,52,64,457
4624,Shawn Lewis,SR,2010-11,G,Cal Poly,Big West,30,938,145,393,103,241,42,152,125,175,33,133,166,67,44,10,94,78,457
4625,Eric Lockett,JR,2017-18,G,Florida International,CUSA,32,1185,181,388,167,340,14,48,81,113,41,168,209,98,39,12,66,76,457
4626,Greg Mangano,JR,2010-11,F,Yale,Ivy,28,897,171,353,141,271,30,82,85,120,56,225,281,15,12,85,57,87,457
4627,Frantz Massenat,JR,2012-13,G,Drexel,CAA,31,1099,141,386,94,241,47,145,128,158,13,61,74,131,24,13,72,82,457
4628,E.C. Matthews,FR,2013-14,G,Rhode Island,A-10,32,1041,150,356,103,221,47,135,110,149,28,110,138,75,30,22,76,77,457
4629,Rickey McGill,JR,2017-18,G,Iona,MAAC,34,1145,163,363,112,230,51,133,80,114,25,113,138,189,52,4,95,71,457
4630,Lamont Middleton,JR,2012-13,G,North Carolina A&T,MEAC,37,1144,134,355,104,245,30,110,159,227,51,102,153,83,35,9,103,80,457
4631,Walter Offutt,JR,2011-12,G,Ohio,MAC,37,1088,148,329,95,190,53,139,108,152,48,86,134,65,57,4,62,94,457
4632,Dylan Osetkowski,JR,2017-18,F,Texas,Big 12,34,1196,161,402,119,256,42,146,93,129,78,166,244,42,35,7,76,63,457
4633,Dyshawn Pierre,JR,2014-15,F,Dayton,A-10,36,1202,164,354,127,250,37,104,92,136,76,215,291,103,22,15,72,65,457
4634,Jared Quayle,JR,2008-09,G,Utah State,WAC,35,1057,152,327,93,175,59,152,94,123,63,146,209,131,50,5,64,60,457
4635,Will Rayman,JR,2018-19,F,Colgate,Patriot,35,1159,157,369,91,215,66,154,77,113,70,157,227,52,32,27,58,101,457
4636,Jason Richards,SR,2007-08,G,Davidson,Southern,36,1264,153,371,95,189,58,182,93,125,17,93,110,293,50,4,104,57,457
4637,Vinnie Shahid,JR,2018-19,G,North Dakota State,Summit,35,1031,143,325,79,150,64,175,107,126,10,95,105,91,26,0,49,60,457
4638,E.J. Singler,SO,2010-11,F,Oregon,Pac-10,39,1188,149,323,94,185,55,138,104,122,64,156,220,66,41,29,58,101,457
4639,Sindarius Thornwell,JR,2015-16,G,South Carolina,SEC,34,1125,144,377,98,239,46,138,123,161,39,125,164,130,50,16,78,66,457
4640,Chad Timberlake,SR,2005-06,G,Fairleigh Dickinson,NEC,30,1090,175,356,136,255,39,101,68,103,59,106,165,126,41,17,63,48,457
4641,Joe Trapani,SO,2008-09,F,Boston College,ACC,34,990,157,363,105,220,52,143,91,115,69,155,224,50,20,35,67,72,457
4642,Alan Voskuil,SR,2008-09,G,Texas Tech,Big 12,33,1176,140,320,49,111,91,209,86,96,26,110,136,69,40,0,46,69,457
4643,Andre Walker,SR,2017-18,G,Loyola (MD),Patriot,29,929,168,438,102,241,66,197,55,93,28,85,113,80,47,0,84,83,457
4644,Martez Walker,SR,2017-18,G,Oakland,Horizon,26,965,138,299,84,137,54,162,127,163,28,78,106,42,23,15,45,50,457
4645,Jaytornah Wisseh,JR,2008-09,G,Long Island University,NEC,30,1045,135,369,98,269,37,100,150,187,20,90,110,133,47,2,96,54,457
4646,Jordan Aaron,SR,2013-14,G,Milwaukee,Horizon,31,1021,138,369,70,171,68,198,112,137,12,84,96,77,34,4,65,78,456
4647,DeMario Anderson,JR,2006-07,G,Quinnipiac,NEC,29,847,186,366,162,290,24,76,60,91,33,93,126,45,50,10,66,83,456
4648,Isaiah Austin,FR,2012-13,C,Baylor,Big 12,35,1046,181,394,151,304,30,90,64,101,88,204,292,39,12,58,65,81,456
4649,Brandon Bos,SR,2014-15,G,South Dakota,Summit,33,1019,147,398,99,260,48,138,114,138,29,90,119,74,13,2,71,54,456
4650,Ky Bowman,FR,2016-17,G,Boston College,ACC,32,920,160,325,98,187,62,138,74,104,25,130,155,92,37,4,93,78,456
4651,Etienne Brower,SR,2007-08,F,Massachusetts,A-10,36,1085,148,324,66,133,82,191,78,113,74,173,247,58,26,48,49,116,456
4652,Paul Carter,SR,2010-11,F,Illinois-Chicago,Horizon,31,1010,156,382,127,285,29,97,115,150,78,171,249,60,20,22,96,88,456
4653,Semaj Christon,FR,2012-13,G,Xavier,A-10,30,1027,162,365,155,337,7,28,125,186,5,81,86,139,45,3,109,80,456
4654,Paris Collins,SO,2015-16,G,Jackson State,SWAC,35,1067,168,455,113,261,55,194,65,105,50,165,215,62,66,23,67,85,456
4655,Kyle Collinsworth,JR,2014-15,G,Brigham Young,WCC,33,1019,158,335,152,314,6,21,134,182,81,205,286,197,59,11,96,73,456
4656,Quenton DeCosey,JR,2014-15,G,Temple,AAC,37,1109,143,379,92,237,51,142,119,177,37,132,169,81,31,12,66,70,456
4657,Matthew Dellavedova,SO,2010-11,G,Saint Mary's (CA),WCC,34,1199,142,340,74,159,68,181,104,118,37,86,123,180,42,1,80,70,456
4658,Malcolm Duvivier,SR,2017-18,G,Akron,MAC,32,1041,159,408,72,175,87,233,51,79,10,71,81,99,27,6,95,94,456
4659,Keyshawn Evans,JR,2017-18,G,Illinois State,MVC,30,935,140,341,49,124,91,217,85,112,10,70,80,107,19,0,63,58,456
4660,Frankie Ferrari,SR,2018-19,G,San Francisco,WCC,31,1050,152,357,79,175,73,182,79,92,8,92,100,172,49,0,62,59,456
4661,Jordan Fouse,SR,2015-16,G,Green Bay,Horizon,36,1137,157,381,116,248,41,133,101,138,73,227,300,118,77,49,78,109,456
4662,Ivan Gandia-Rosa,SO,2017-18,G,North Florida,A-Sun,33,1080,149,357,73,151,76,206,82,92,12,77,89,205,18,0,103,36,456
4663,Tyree Griffin,SR,2018-19,G,Southern Mississippi,CUSA,33,1140,165,379,111,234,54,145,72,100,15,97,112,233,65,3,87,55,456
4666,Andre Hollins,JR,2014-15,G,Minnesota,Big Ten,33,1007,153,366,71,167,82,199,68,90,27,105,132,89,35,6,61,72,456
4667,Franko House,SR,2016-17,F,Ball State,MAC,34,891,165,314,144,256,21,58,105,138,74,145,219,79,14,20,75,112,456
4668,Jordan Howard,FR,2014-15,G,Central Arkansas,Southland,29,978,146,360,69,162,77,198,87,111,6,66,72,56,14,0,77,38,456
4669,Zak Irvin,SO,2014-15,G,Michigan,Big Ten,32,1160,163,405,86,188,77,217,53,76,31,122,153,49,33,3,47,42,456
4670,Wesley Iwundu,SR,2016-17,F,Kansas State,Big 12,35,1098,151,314,119,229,32,85,122,159,36,185,221,121,35,12,81,63,456
4671,Roosevelt Jones,SR,2015-16,F,Butler,Big East,33,1109,166,355,165,354,1,1,123,182,67,151,218,154,50,13,77,82,456
4672,Robo Kreps,JR,2009-10,G,Illinois-Chicago,Horizon,30,1070,142,400,86,211,56,189,116,137,22,94,116,64,42,1,65,38,456
4673,Chris Long,SR,2010-11,G,Elon,Southern,31,1044,126,297,72,137,54,160,150,185,19,59,78,188,53,2,69,73,456
4674,Deandre Mathieu,JR,2013-14,G,Minnesota,Big Ten,38,1145,165,323,143,278,22,45,104,138,18,85,103,160,60,3,102,83,456
4675,Javon McCrea,SO,2011-12,F,Buffalo,MAC,31,784,190,332,190,331,0,1,76,136,88,127,215,58,32,38,69,97,456
4676,Jordan McLaughlin,SO,2015-16,G,Southern California,Pac-12,34,1100,162,344,106,212,56,132,76,103,17,111,128,161,55,5,81,34,456
4677,Anthony Morrow,SR,2007-08,G,Georgia Tech,ACC,32,951,154,336,73,155,81,181,67,78,37,93,130,34,36,10,33,60,456
4678,Andrew Nicholas,JR,2013-14,G,Monmouth,MAAC,32,969,165,421,103,244,62,177,64,90,29,77,106,35,29,14,61,88,456
4679,Chuma Okeke,SO,2018-19,F,Auburn,SEC,38,1105,168,339,113,197,55,142,65,90,106,154,260,73,69,46,66,71,456
4680,Prince Okoroh,JR,2013-14,G,Howard,MEAC,33,1095,158,417,144,366,14,51,126,183,55,121,176,37,51,15,88,82,456
4681,Josh Perkins,JR,2017-18,G,Gonzaga,WCC,37,1216,156,355,73,144,83,211,61,81,19,97,116,196,44,3,77,94,456
4682,Justin Pierce,SO,2017-18,G,William & Mary,CAA,31,980,163,325,116,212,47,113,83,105,63,204,267,75,28,19,56,66,456
4683,Rodney Purvis,SR,2016-17,G,Connecticut,AAC,33,1217,151,406,74,180,77,226,77,95,13,126,139,84,34,8,59,71,456
4684,Nick Sherod,SO,2017-18,G,Richmond,A-10,32,1008,165,343,104,187,61,156,65,81,31,128,159,45,31,4,36,58,456
4685,Jason Siggers,SR,2006-07,G,Albany (NY),AEC,33,1029,169,383,123,238,46,145,72,88,52,78,130,75,23,11,70,83,456
4688,Tyler Stone,SO,2011-12,F,Southeast Missouri State,OVC,31,918,193,364,185,341,8,23,62,100,53,174,227,26,21,34,48,71,456
4689,Romeo Travis,JR,2005-06,F,Akron,MAC,33,1009,175,334,170,318,5,16,101,156,66,160,226,62,34,30,57,83,456
4690,Omar Wattad,JR,2010-11,G,Chattanooga,Southern,32,936,143,379,55,135,88,244,82,110,39,78,117,65,27,2,65,79,456
4691,Royce White,SO,2011-12,F,Iowa State,Big 12,34,1072,175,328,171,316,4,12,102,205,85,231,316,170,40,32,130,89,456
4692,Jordan Williams,SR,2014-15,G,North Texas,CUSA,31,1062,153,392,112,243,41,149,109,149,42,110,152,64,47,15,83,69,456
4693,McKinley Wright IV,SO,2018-19,G,Colorado,Pac-12,35,1133,161,326,123,222,38,104,96,119,28,145,173,167,39,7,108,58,456
4694,Isaiah Wright,JR,2017-18,G,San Diego,WCC,34,1173,147,326,94,191,53,135,109,149,11,157,168,181,44,4,105,93,456
4695,Julian Wright,SO,2006-07,F,Kansas,Big 12,38,1048,190,346,187,333,3,13,73,119,96,202,298,82,55,49,91,94,456
4696,Kris Acox,SR,2016-17,F,Furman,Southern,35,1003,199,317,199,317,0,0,57,102,78,191,269,48,49,25,67,91,455
4697,Quincy Acy,SR,2011-12,F,Baylor,Big 12,38,1130,158,274,155,269,3,5,136,174,99,183,282,38,35,70,71,117,455
4698,Noruwa Agho,SO,2009-10,G,Columbia,Ivy,28,966,151,355,93,225,58,130,95,130,28,90,118,53,37,1,67,49,455
4699,Olu Ashaolu,JR,2010-11,F,Louisiana Tech,WAC,32,990,163,309,151,268,12,41,117,194,86,214,300,52,31,10,111,116,455
4700,Byron Ashe,JR,2015-16,G,Mount St. Mary's,NEC,33,1030,166,412,113,242,53,170,70,97,31,118,149,56,42,16,58,92,455
4701,Justin Bowen,SR,2005-06,F,Illinois-Chicago,Horizon,31,1003,182,347,173,320,9,27,82,105,77,134,211,32,40,20,47,83,455
4702,Michael Bramos,JR,2007-08,F,Miami (OH),MAC,28,972,150,345,85,166,65,179,90,107,18,91,109,33,36,42,37,48,455
4703,Zac Cuthbertson,JR,2017-18,F,Coastal Carolina,Sun Belt,31,909,141,313,112,217,29,96,144,181,58,152,210,49,29,22,72,85,455
4704,Ronald Delph,SR,2017-18,C,Florida Atlantic,CUSA,31,910,201,405,201,403,0,2,53,76,84,186,270,23,13,63,52,82,455
4705,Jeremiah Dominguez,JR,2007-08,G,Portland State,Big Sky,32,989,153,325,69,131,84,194,65,80,14,54,68,130,62,2,78,51,455
4706,Andre Fox,JR,2017-18,G,High Point,Big South,29,829,150,316,95,187,55,129,100,133,15,125,140,40,36,8,59,63,455
4707,Warren Gillis,SR,2014-15,G,Coastal Carolina,Big South,34,1064,160,366,134,281,26,85,109,125,22,84,106,108,48,3,88,76,455
4710,Justin Graham,SR,2010-11,G,San Jose State,WAC,32,1161,163,388,126,299,37,89,92,138,25,119,144,141,73,12,72,77,455
4711,David Hanson,JR,2010-11,F,Cal Poly,Big West,30,1060,165,402,92,200,73,202,52,83,63,121,184,55,30,8,37,68,455
4712,Josh Hawkinson,SO,2014-15,F,Washington State,Pac-12,31,1015,166,332,159,297,7,35,116,136,65,269,334,30,12,34,32,67,455
4713,Dakarai Henderson,JR,2015-16,G,Sam Houston State,Southland,32,953,151,397,76,178,75,219,78,113,26,65,91,47,19,2,42,48,455
4714,Jeromie Hill,FR,2010-11,F,Texas-San Antonio,Southland,34,1037,177,373,135,268,42,105,59,93,69,156,225,35,26,17,87,82,455
4715,Ian Hummer,SR,2012-13,F,Princeton,Ivy,28,952,171,331,164,307,7,24,106,147,51,127,178,115,36,23,79,64,455
4716,Holton Hunsaker,SR,2013-14,G,Utah Valley,WAC,32,1076,118,351,51,152,67,199,152,176,2,70,72,134,32,0,87,76,455
4717,Kareem Jamar,JR,2012-13,G,Montana,Big Sky,32,1119,157,318,119,211,38,107,103,145,36,152,188,129,29,21,93,79,455
4718,Scottie James,JR,2018-19,F,Liberty,A-Sun,36,882,175,263,167,239,8,24,97,136,103,206,309,39,11,20,62,72,455
4719,Joseph Jones,JR,2006-07,C,Texas A&M,Big 12,34,929,159,288,147,258,12,30,125,160,84,146,230,43,39,26,54,114,455
4720,Paris Lee,SR,2016-17,G,Illinois State,MVC,35,1080,149,354,68,160,81,194,76,97,11,117,128,176,65,4,86,50,455
4721,Ray Lee,SR,2016-17,G,Eastern Michigan,MAC,29,755,144,356,91,207,53,149,114,133,13,36,49,72,45,2,80,64,455
4722,Shake Milton,SO,2016-17,G,Southern Methodist,AAC,35,1239,152,348,70,154,82,194,69,91,15,129,144,159,44,11,63,54,455
4723,Stefan Moody,FR,2012-13,G,Florida Atlantic,Sun Belt,29,908,151,359,99,212,52,147,101,124,19,102,121,65,21,9,91,59,455
4724,Jovan Mooring,SR,2017-18,G,Nevada-Las Vegas,MWC,33,1077,135,362,72,160,63,202,122,152,9,91,100,110,38,2,62,75,455
4725,Matt Mullery,SR,2009-10,F,Brown,Ivy,30,939,165,303,157,268,8,35,117,164,40,147,187,86,22,48,83,65,455
4726,Mark Nwakamma,SO,2012-13,F,Hartford,AEC,31,883,178,375,161,323,17,52,82,133,47,123,170,57,44,21,101,102,455
4727,David Patten,SR,2006-07,F,Weber State,Big Sky,32,866,167,313,145,255,22,58,99,180,58,114,172,33,37,34,65,79,455
4728,Adrian Powell,SR,2012-13,F,North Carolina A&T,MEAC,37,1159,162,408,100,238,62,170,69,118,43,140,183,72,66,12,78,70,455
4729,Marvin Prochet,SR,2018-19,F,Niagara,MAAC,29,933,150,356,75,178,75,178,80,115,50,163,213,49,21,23,48,53,455
4732,Evan Roquemore,JR,2012-13,G,Santa Clara,WCC,38,1194,138,330,89,184,49,146,130,160,20,102,122,196,46,8,83,78,455
4733,Keith Simmons,JR,2005-06,G,Holy Cross,Patriot,32,995,158,301,98,175,60,126,79,97,67,99,166,47,37,10,49,66,455
4734,Addison Spruill,SR,2014-15,G,North Carolina-Wilmington,CAA,32,981,165,371,151,320,14,51,111,152,57,152,209,52,30,16,73,81,455
4735,B.J. Stith,JR,2017-18,G,Old Dominion,CUSA,32,1006,157,359,101,220,56,139,85,101,24,157,181,55,25,5,50,58,455
4736,Michael Tveidt,JR,2009-10,F,North Dakota State,Summit,29,997,181,417,152,321,29,96,64,82,34,129,163,44,35,12,61,81,455
4737,Eric Washington,JR,2014-15,G,Miami (OH),MAC,32,1029,137,304,111,225,26,79,155,195,26,76,102,176,45,1,108,71,455
4738,Maalik Wayns,SO,2010-11,G,Villanova,Big East,33,994,141,353,109,235,32,118,141,172,21,72,93,148,38,1,91,78,455
4739,Kelly Whitney,SR,2005-06,F,Seton Hall,Big East,30,1085,163,360,163,360,0,0,129,184,88,150,238,36,36,22,88,83,455
4740,C.J. Wilcox,SO,2011-12,G,Washington,Pac-12,32,912,152,348,79,167,73,181,78,93,26,82,108,39,29,20,40,63,455
4741,Jeff Allen,SR,2010-11,F,Virginia Tech,ACC,34,1097,178,355,173,321,5,34,93,141,92,238,330,60,44,25,99,117,454
4742,Terry Allen,JR,2014-15,F,Richmond,A-10,35,1093,170,331,154,265,16,66,98,131,56,177,233,47,48,23,67,77,454
4743,Carlon Brown,SR,2011-12,G,Colorado,Pac-12,36,1027,169,378,126,238,43,140,73,101,31,105,136,73,28,10,70,59,454
4744,Antwan Carter,SO,2009-10,C,Longwood,Ind,31,779,196,374,191,356,5,18,57,92,106,159,265,26,25,20,70,105,454
4745,Travis Charles,SR,2017-18,F,Albany (NY),AEC,31,896,174,314,174,314,0,0,106,129,60,115,175,22,17,13,55,87,454
4746,Sherron Dorsey-Walker,SR,2016-17,G,Oakland,Horizon,34,1114,139,358,69,167,70,191,106,140,19,153,172,129,37,6,74,66,454
4747,Muhammad El-Amin,JR,2008-09,G,Stony Brook,AEC,29,768,159,364,111,239,48,125,88,107,39,61,100,34,18,2,64,55,454
4748,Brandon Fortenberry,SR,2012-13,G,Southeastern Louisiana,Southland,31,1101,148,369,98,222,50,147,108,147,24,114,138,86,29,8,58,59,454
4749,Ja'Dante' Frye,SR,2016-17,F,Nicholls State,Southland,31,1044,157,344,119,239,38,105,102,132,55,130,185,48,26,14,60,59,454
4750,Jay Harris,SR,2014-15,G,Illinois-Chicago,Horizon,30,974,122,318,71,161,51,157,159,177,19,71,90,110,39,3,84,57,454
4751,Roy Hibbert,SR,2007-08,C,Georgetown,Big East,34,894,179,294,176,291,3,3,93,144,75,141,216,63,18,75,57,92,454
4752,Tra Holder,SO,2015-16,G,Arizona State,Pac-12,32,1017,140,362,91,228,49,134,125,172,22,90,112,117,33,2,84,66,454
4753,Kelsey Howard,SO,2011-12,G,Jackson State,SWAC,31,999,151,390,105,246,46,144,106,139,39,88,127,28,30,4,78,73,454
4754,Shawn Huff,SR,2007-08,G,Valparaiso,Horizon,36,1130,153,314,62,124,91,190,57,68,42,119,161,56,10,18,77,75,454
4755,Casey Jones,SO,2014-15,G,Chattanooga,Southern,32,945,168,324,165,312,3,12,115,162,80,145,225,59,37,37,85,82,454
4756,Jamal Jones,JR,2013-14,G,Texas A&M,SEC,34,945,147,403,65,179,82,224,78,104,34,104,138,43,25,12,53,61,454
4757,LeAntwan Luckett,SO,2012-13,F,Alcorn State,SWAC,34,1117,158,421,145,351,13,70,125,193,47,89,136,80,34,8,97,98,454
4758,Sam Maniscalco,SO,2008-09,G,Bradley,MVC,36,1181,138,336,67,130,71,206,107,128,4,64,68,110,41,0,74,81,454
4759,Stephen Maxwell,SO,2012-13,F,Cal State Northridge,Big West,31,865,173,311,173,311,0,0,108,149,119,138,257,16,30,10,53,73,454
4760,Tahjere McCall,SR,2015-16,G,Tennessee State,OVC,31,932,138,303,118,231,20,72,158,209,47,112,159,93,72,11,97,101,454
4761,Jamie McNeilly,SR,2006-07,G,New Orleans,Sun Belt,30,1128,157,350,95,197,62,153,78,98,17,95,112,90,48,6,59,74,454
4762,Afam Muojeke,FR,2008-09,G,Wyoming,MWC,33,991,154,333,113,209,41,124,105,144,18,157,175,51,27,13,106,66,454
4763,Justin Nabors,SR,2009-10,F,Lamar,Southland,31,955,165,322,159,301,6,21,118,172,110,191,301,50,27,21,103,80,454
4764,Obadiah Noel,SO,2018-19,G,Massachusetts-Lowell,AEC,31,894,160,309,135,231,25,78,109,150,38,71,109,62,40,11,69,78,454
4765,Marcus Paige,SR,2015-16,G,North Carolina,ACC,34,1075,147,370,69,150,78,220,82,103,15,71,86,127,39,15,42,51,454
4766,Gerald Robinson,SR,2011-12,G,Georgia,SEC,32,979,159,367,133,296,26,71,110,138,21,102,123,114,41,2,79,60,454
4767,Matt Stainbrook,SR,2014-15,C,Xavier,Big East,37,987,173,282,172,277,1,5,107,140,73,184,257,89,22,24,73,93,454
4768,Anthony Tarke,SO,2017-18,G,NJIT,A-Sun,29,930,161,399,120,256,41,143,91,142,45,136,181,57,38,24,60,65,454
4769,Sindarius Thornwell,FR,2013-14,G,South Carolina,SEC,34,1007,143,370,106,270,37,100,131,178,48,91,139,101,40,21,106,100,454
4770,Dante Thorpe,SR,2018-19,G,Northern Illinois,MAC,33,1064,169,319,141,249,28,70,88,110,17,76,93,82,37,0,63,78,454
4771,Austin Tillotson,SR,2015-16,G,Colgate,Patriot,30,1032,161,370,105,206,56,164,76,95,20,79,99,155,58,1,72,56,454
4774,Sebastian Townes,JR,2018-19,F,Bryant,NEC,30,874,159,344,130,260,29,84,107,163,54,94,148,37,13,6,66,86,454
4775,Anthony Vereen,JR,2007-08,F,Texas-Arlington,Southland,33,752,146,257,138,229,8,28,154,209,45,112,157,54,21,3,79,97,454
4776,Corey Walden,SO,2012-13,G,Eastern Kentucky,OVC,35,1019,142,285,101,171,41,114,129,147,28,93,121,65,61,4,57,105,454
4777,DeVaughn Washington,SR,2010-11,F,Ohio,MAC,34,1004,167,320,166,319,1,1,119,188,59,133,192,32,36,13,62,102,454
4778,DaShaun Wiggins,SR,2014-15,G,Portland State,Big Sky,29,823,133,322,74,187,59,135,129,176,17,93,110,47,44,2,59,79,454
4779,Jamaal Williams,SR,2005-06,F,Washington,Pac-10,33,781,200,403,199,401,1,2,53,79,75,81,156,43,44,25,63,79,454
4780,Jerrell Williams,SR,2010-11,F,La Salle,A-10,33,878,173,358,170,348,3,10,105,177,114,129,243,46,37,7,111,108,454
4781,Tim Williams,FR,2012-13,F,Samford,Southern,32,1119,178,327,178,327,0,0,98,144,58,170,228,25,47,35,48,67,454
4782,McKinley Wright IV,FR,2017-18,G,Colorado,Pac-12,32,1042,166,368,138,276,28,92,94,122,52,97,149,175,31,14,94,49,454
4783,Michael Young,SO,2014-15,F,Pittsburgh,ACC,34,1077,167,315,162,298,5,17,115,166,111,138,249,44,21,28,38,89,454
4784,Talib Zanna,JR,2013-14,F,Pittsburgh,ACC,35,1061,160,273,160,271,0,2,134,201,115,185,300,19,22,29,54,90,454
4785,Chase Adams,JR,2008-09,G,Centenary (LA),Summit,31,,142,327,70,146,72,181,97,138,,,131,141,83,2,63,,453
4786,Ben Aird,JR,2012-13,C,Utah Valley,GWC,30,1009,177,308,170,284,7,24,92,125,79,190,269,28,24,58,35,83,453
4787,O'Darien Bassett,JR,2006-07,G,Troy,Sun Belt,30,928,161,389,106,244,55,145,76,100,12,51,63,91,28,3,82,50,453
4788,Justin Black,JR,2012-13,G,Morgan State,MEAC,32,1064,165,376,128,264,37,112,86,141,76,59,135,94,39,1,94,81,453
4789,Jon Brockman,SO,2006-07,F,Washington,Pac-10,32,921,175,318,175,318,0,0,103,156,117,190,307,35,24,4,84,90,453
4790,Ahmad Caver,JR,2017-18,G,Old Dominion,CUSA,32,1189,155,380,90,194,65,186,78,117,19,94,113,197,73,5,65,52,453
4791,Daryl Cohen,SR,2006-07,G,Southeastern Louisiana,Southland,30,912,155,394,50,109,105,285,38,58,20,76,96,26,30,6,47,51,453
4792,Dikembe Dixson,SO,2017-18,F,Illinois-Chicago,Horizon,32,950,149,383,114,272,35,111,120,164,22,89,111,26,40,6,89,58,453
4793,Kevin Downey,SR,2005-06,G,Canisius,MAAC,29,1077,176,367,132,237,44,130,57,74,25,112,137,97,36,0,62,46,453
4796,Anthony Downing,SR,2012-13,G,Missouri State,MVC,33,1133,150,375,115,239,35,136,118,148,33,112,145,88,35,2,55,68,453
4797,Madarious Gibbs,SR,2014-15,G,Texas Southern,SWAC,32,1234,158,368,135,277,23,91,114,169,20,86,106,135,30,2,92,71,453
4798,Matt Haryasz,SR,2005-06,F,Stanford,Pac-10,28,917,156,325,152,310,4,15,137,183,75,169,244,39,16,47,60,65,453
4799,Andrew Hayles,JR,2007-08,G,Alabama State,SWAC,31,981,155,345,89,172,66,173,77,102,32,81,113,54,35,4,46,55,453
4800,Corey Henson,SO,2015-16,G,Wagner,NEC,34,1025,155,362,81,178,74,184,69,84,21,82,103,98,39,1,61,77,453
4801,Boomer Herndon,JR,2005-06,C,Belmont,A-Sun,31,702,184,318,184,318,0,0,85,145,107,123,230,25,23,56,78,81,453
4802,Travis Holmes,JR,2007-08,F,Virginia Military Institute,Big South,29,798,148,361,107,209,41,152,116,150,53,117,170,80,63,17,79,65,453
4803,Tony Hooper,JR,2007-08,G,Louisiana-Monroe,Sun Belt,30,866,156,371,94,174,62,197,79,116,23,48,71,72,47,6,106,94,453
4804,Deonte Huff,SR,2007-08,G,Portland State,Big Sky,33,1012,155,307,131,229,24,78,119,159,71,128,199,85,42,6,81,69,453
4805,Kevin Lisch,JR,2007-08,G,Saint Louis,A-10,31,1068,137,320,74,156,63,164,116,143,12,106,118,97,38,4,64,63,453
4806,Randy Miller Jr.,SR,2018-19,G,North Carolina Central,MEAC,34,972,139,332,73,154,66,178,109,135,13,68,81,64,29,1,67,66,453
4807,Ian Miller,SR,2013-14,G,Florida State,ACC,33,938,146,325,81,162,65,163,96,110,11,72,83,92,24,1,96,64,453
4808,Justin Patton,FR,2016-17,C,Creighton,Big East,35,885,200,296,192,281,8,15,45,87,59,159,218,41,30,50,60,96,453
4809,Evan Payne,JR,2016-17,G,Long Beach State,Big West,32,875,146,353,90,197,56,156,105,122,20,100,120,38,25,5,61,51,453
4810,JayVaughn Pinkston,SO,2012-13,F,Villanova,Big East,34,889,136,293,126,256,10,37,171,241,63,107,170,58,33,16,86,89,453
4811,K.C. Rivers,SR,2008-09,G,Clemson,ACC,32,991,173,385,104,209,69,176,38,57,64,129,193,52,55,14,44,48,453
4812,Fatts Russell,SO,2018-19,G,Rhode Island,A-10,32,1090,149,441,109,262,40,179,115,156,18,69,87,117,56,10,74,81,453
4813,Rodriguez Sherman,SR,2010-11,G,Kent State,MAC,36,1099,158,347,112,223,46,124,91,121,52,85,137,103,56,4,88,83,453
4814,Devin Sibley,SR,2017-18,G,Furman,Southern,32,850,172,373,121,221,51,152,58,106,14,143,157,63,25,10,87,63,453
4815,Terence Smith,JR,2013-14,G,Tennessee-Martin,OVC,31,960,134,312,74,175,60,137,125,152,35,77,112,86,31,4,45,80,453
4818,Bryan Smithson,JR,2006-07,G,North Carolina-Asheville,Big South,31,960,156,374,113,253,43,121,98,115,18,94,112,84,60,8,92,53,453
4819,Dylan Talley,SR,2012-13,G,Nebraska,Big Ten,33,1173,161,433,110,284,51,149,80,108,27,130,157,81,30,8,71,74,453
4820,Ayinde Ubaka,SR,2006-07,G,University of California,Pac-10,33,1158,152,361,93,196,59,165,90,116,14,85,99,142,24,1,67,50,453
4821,Benny Valentine,JR,2008-09,G,Eastern Washington,Big Sky,30,908,160,406,105,248,55,158,78,108,10,73,83,92,44,0,81,85,453
4822,Travis Wallace,JR,2012-13,F,North Florida,A-Sun,32,764,183,317,182,316,1,1,86,130,58,108,166,21,17,29,49,57,453
4823,Christian Watford,JR,2011-12,F,Indiana,Big Ten,36,1023,141,339,89,220,52,119,119,146,42,166,208,48,27,16,62,73,453
4824,Ryan Wedel,SO,2007-08,G,Arkansas State,Sun Belt,30,959,148,343,58,119,90,224,67,82,9,67,76,50,30,5,53,63,453
4825,Jordan Williams,SO,2012-13,G,North Texas,Sun Belt,32,1014,153,368,107,233,46,135,101,138,50,69,119,23,23,18,69,72,453
4826,Kendall Williams,JR,2012-13,G,New Mexico,MWC,34,1170,126,310,78,172,48,138,153,200,17,103,120,166,38,3,72,48,453
4827,Elijah Wilson,JR,2015-16,G,Coastal Carolina,Big South,33,1028,156,396,80,185,76,211,65,93,30,102,132,31,25,8,56,70,453
4828,Derrick Barden,SR,2013-14,F,Northern Colorado,Big Sky,32,983,180,313,164,270,16,43,76,115,99,150,249,40,41,16,35,48,452
4829,Beau Beech,JR,2014-15,G,North Florida,A-Sun,35,1065,149,351,60,118,89,233,65,83,36,164,200,50,43,10,64,92,452
4830,Jeremiah Bell,JR,2017-18,G,Milwaukee,Horizon,32,975,157,371,82,175,75,196,63,83,10,92,102,57,38,3,44,74,452
4831,Johnnie Bryant,JR,2006-07,G,Utah,MWC,30,1036,150,344,62,136,88,208,64,78,17,65,82,81,14,0,52,55,452
4832,Brian Burrell,JR,2006-07,G,Texas-Rio Grande Valley,Ind,29,915,161,372,80,169,81,203,49,56,37,111,148,41,42,3,55,57,452
4833,Kenny Carpenter,SR,2017-18,G,Cleveland State,Horizon,34,1146,177,372,120,211,57,161,41,58,24,149,173,82,37,15,42,79,452
4834,Tre' Coggins,JR,2015-16,G,Cal State Fullerton,Big West,29,865,145,368,70,158,75,210,87,102,14,98,112,52,20,4,71,61,452
4835,Erik Etherly,JR,2011-12,F,Loyola (MD),MAAC,33,1030,168,317,165,306,3,11,113,162,83,163,246,63,35,48,79,65,452
4836,Armon Fletcher,JR,2017-18,G,Southern Illinois,MVC,32,1011,153,315,113,200,40,115,106,145,46,116,162,54,38,16,41,73,452
4837,Taj Gibson,FR,2006-07,F,Southern California,Pac-10,37,1198,174,312,174,312,0,0,104,167,101,220,321,55,20,69,107,110,452
4840,Mustapha Heron,JR,2018-19,G,St. John's (NY),Big East,31,982,153,348,105,229,48,119,98,130,30,114,144,41,33,6,71,97,452
4841,Jordan Hill,SR,2017-18,G,Seattle,WAC,33,1112,150,378,76,174,74,204,78,101,19,107,126,114,41,14,99,107,452
4842,Solomon Hill,JR,2011-12,F,Arizona,Pac-12,35,1134,151,302,114,207,37,95,113,156,76,195,271,91,36,18,86,91,452
4843,David Holston,JR,2006-07,G,Chicago State,Ind,29,961,147,366,53,132,94,234,64,77,41,50,91,100,44,3,73,83,452
4844,Troy Huff,FR,2010-11,G,North Dakota,GWC,34,894,165,377,126,259,39,118,83,133,57,100,157,38,41,11,75,51,452
4845,Justin Ingram,JR,2005-06,G,Toledo,MAC,31,981,134,330,77,161,57,169,127,145,20,79,99,91,58,9,66,60,452
4846,Dominic James,JR,2007-08,G,Marquette,Big East,35,1060,159,399,114,254,45,145,89,134,31,62,93,154,62,8,75,76,452
4847,Tony Johnson,SR,2012-13,G,Lafayette,Patriot,34,1060,166,304,137,241,29,63,91,112,20,109,129,162,65,7,76,65,452
4848,Christian Kessee,JR,2015-16,G,Coppin State,MEAC,31,1007,150,385,62,162,88,223,64,80,15,62,77,58,20,0,63,74,452
4849,Michael Kessens,FR,2012-13,F,Longwood,Big South,33,1078,174,324,170,306,4,18,100,143,86,204,290,47,38,42,96,105,452
4850,Marvin Lea,SR,2006-07,G,Pepperdine,WCC,31,947,151,407,102,258,49,149,101,162,42,108,150,96,62,3,87,65,452
4851,Alex Len,SO,2012-13,C,Maryland,ACC,38,1004,173,324,172,316,1,8,105,153,109,189,298,37,8,78,60,101,452
4852,Mike Lewis II,FR,2016-17,G,Duquesne,A-10,32,1025,140,342,77,167,63,175,109,131,4,68,72,53,20,1,63,65,452
4853,Scottie Lindsey,JR,2016-17,G,Northwestern,Big Ten,32,975,163,384,105,204,58,180,68,81,17,105,122,73,30,9,45,73,452
4854,Frank Mason,SO,2014-15,G,Kansas,Big 12,36,1207,150,340,108,242,42,98,110,140,22,119,141,142,50,4,74,65,452
4855,Matt Mullery,JR,2008-09,F,Brown,Ivy,28,927,174,287,166,267,8,20,96,149,55,128,183,56,22,59,69,72,452
4856,Abdel Nader,SR,2015-16,F,Iowa State,Big 12,35,1088,161,337,109,197,52,140,78,106,26,148,174,54,37,23,79,98,452
4857,Shane Nichols,JR,2006-07,G,Wofford,Southern,29,926,140,327,55,126,85,201,87,106,14,51,65,52,15,3,49,58,452
4858,Sir'Dominic Pointer,SR,2014-15,G,St. John's (NY),Big East,33,1143,175,334,173,309,2,25,100,138,64,189,253,98,63,80,66,99,452
4859,Leon Powell,JR,2010-11,F,Southeast Missouri State,OVC,32,1007,172,273,172,273,0,0,108,205,103,144,247,32,19,49,58,117,452
4860,Ryan Rhoomes,SR,2015-16,F,Fordham,A-10,31,984,187,289,187,289,0,0,78,133,130,171,301,42,21,57,63,100,452
4861,Latif Rivers,SO,2011-12,G,Wagner,NEC,31,941,143,351,84,183,59,168,107,121,12,70,82,68,22,12,67,79,452
4862,Kerwin Roach Jr.,SR,2018-19,G,Texas,Big 12,31,905,156,355,102,203,54,152,86,125,20,113,133,100,36,9,70,70,452
4863,Willie Rodriguez,SO,2015-16,F,Binghamton,AEC,30,945,156,346,134,262,22,84,118,154,66,134,200,39,32,9,78,84,452
4864,Diamon Simpson,SO,2006-07,F,Saint Mary's (CA),WCC,32,909,155,320,149,290,6,30,136,211,107,138,245,28,43,79,84,79,452
4865,Stephen Sir,SR,2006-07,G,Northern Arizona,Big Sky,30,826,142,302,18,49,124,253,44,50,6,61,67,48,15,2,49,66,452
4866,Devin Thomas,SR,2015-16,F,Wake Forest,ACC,29,891,162,299,162,299,0,0,128,219,89,207,296,70,19,46,81,88,452
4867,Rashawn Thomas,SO,2014-15,F,Texas A&M-Corpus Christi,Southland,33,913,154,281,154,275,0,6,144,226,95,167,262,34,18,40,103,121,452
4868,Kris Wilkes,FR,2017-18,G,UCLA,Pac-12,33,983,160,363,104,204,56,159,76,116,43,119,162,56,25,18,44,83,452
4869,Jason Williams,SR,2005-06,G,Texas-El Paso,CUSA,30,1039,163,335,151,297,12,38,114,178,79,142,221,108,46,7,90,55,452
4870,DeVaughn Akoon-Purcell,SR,2015-16,G,Illinois State,MVC,32,895,157,364,138,291,19,73,118,165,51,107,158,60,30,13,86,62,451
4871,Jeff Allen,SO,2008-09,F,Virginia Tech,ACC,33,1006,158,324,141,282,17,42,118,193,93,184,277,43,61,42,90,115,451
4872,Schadrac Casimir,SR,2018-19,G,Florida Gulf Coast,A-Sun,32,986,134,279,60,124,74,155,109,124,17,67,84,76,31,0,67,45,451
4873,Maurice Creek,SR,2013-14,G,George Washington,A-10,32,940,145,350,65,150,80,200,81,109,23,85,108,56,34,5,69,69,451
4874,Jeantal Cylla,JR,2018-19,F,North Carolina-Wilmington,CAA,33,930,156,365,123,259,33,106,106,125,48,103,151,18,17,17,46,86,451
4875,Kyvon Davenport,JR,2017-18,F,Memphis,AAC,34,995,153,300,114,190,39,110,106,153,71,138,209,27,21,42,56,95,451
4876,Rodney Elliott,FR,2013-14,G,Maryland-Baltimore County,AEC,30,941,141,312,96,185,45,127,124,178,19,99,118,108,40,1,108,101,451
4877,Phil Fayne,JR,2017-18,F,Illinois State,MVC,29,866,181,304,181,304,0,0,89,173,99,117,216,27,35,28,51,82,451
4878,Phil Forte,SO,2013-14,G,Oklahoma State,Big 12,34,976,129,302,29,75,100,227,93,107,12,50,62,46,29,1,22,46,451
4879,Jarrid Frye,JR,2005-06,G,Sacred Heart,NEC,28,888,162,361,143,286,19,75,108,161,42,138,180,73,49,14,88,85,451
4882,Novar Gadson,JR,2010-11,G,Rider,MAAC,33,924,163,347,124,243,39,104,86,128,43,148,191,56,27,31,79,97,451
4883,Clide Geffrard,SR,2015-16,F,Stephen F. Austin,Southland,34,825,153,312,108,182,45,130,100,125,70,130,200,47,31,19,56,79,451
4884,Daniel Hamilton,SO,2015-16,G,Connecticut,AAC,36,1147,159,411,112,269,47,142,86,100,33,288,321,170,38,15,85,66,451
4885,T.J. Holyfield,JR,2017-18,F,Stephen F. Austin,Southland,35,956,167,305,139,237,28,68,89,119,84,139,223,30,40,44,95,101,451
4886,Keith Hornsby,SO,2012-13,G,North Carolina-Asheville,Big South,30,1007,151,348,101,216,50,132,99,107,25,101,126,94,43,7,67,52,451
4887,Aundre Jackson,JR,2016-17,F,Loyola (IL),MVC,32,764,178,266,164,235,14,31,81,118,39,94,133,31,17,11,54,80,451
4888,Donovan Jackson,SR,2017-18,G,Iowa State,Big 12,30,1032,143,375,48,138,95,237,70,80,8,55,63,62,15,2,48,62,451
4889,Trejon Jacob,SO,2017-18,G,Florida International,CUSA,31,1043,158,367,86,175,72,192,63,98,26,128,154,28,35,8,37,51,451
4890,Deckie Johnson,JR,2015-16,G,North Texas,CUSA,31,1007,140,361,67,141,73,220,98,124,44,95,139,69,29,6,59,77,451
4891,Steffan Johnson,JR,2007-08,G,Pacific,Big West,31,971,151,327,87,171,64,156,85,114,14,75,89,151,45,8,107,36,451
4892,Raijon Kelly,SO,2012-13,G,Samford,Southern,32,1180,161,388,100,237,61,151,68,87,13,60,73,151,27,3,103,77,451
4893,Jonathan Lee,JR,2011-12,G,Northeastern,CAA,31,1089,151,320,101,200,50,120,99,126,28,90,118,107,46,3,97,74,451
4894,Loudon Love,FR,2017-18,C,Wright State,Horizon,35,972,186,349,186,348,0,1,79,146,106,235,341,38,27,34,84,95,451
4895,Joey Lynch-Flohr,JR,2008-09,C,Radford,Big South,33,980,170,327,170,327,0,0,111,154,79,117,196,48,21,13,72,105,451
4896,Charles Minlend,SO,2018-19,G,San Francisco,WCC,31,940,159,382,115,229,44,153,89,128,41,104,145,52,28,16,47,43,451
4897,Kenneth Ogbe,SR,2017-18,G,Utah Valley,WAC,33,1002,150,311,83,155,67,156,84,121,19,85,104,49,26,7,57,60,451
4898,Jordan Sibert,JR,2013-14,G,Dayton,A-10,37,963,147,323,64,128,83,195,74,104,14,70,84,55,30,4,46,64,451
4899,Kyle Singler,FR,2007-08,F,Duke,ACC,34,972,159,348,108,198,51,150,82,106,70,128,198,48,36,25,75,104,451
4900,Malik Smith,JR,2012-13,G,Florida International,Sun Belt,32,1060,135,371,39,106,96,265,85,111,14,73,87,41,31,1,66,70,451
4901,Martin Smith,JR,2013-14,F,Lipscomb,A-Sun,29,946,134,327,66,138,68,189,115,142,30,78,108,66,28,9,53,64,451
4904,James Southerland,SR,2012-13,F,Syracuse,Big East,34,1003,161,358,77,147,84,211,45,57,44,133,177,36,49,28,39,79,451
4905,Chehales Tapscott,SR,2011-12,F,Portland State,Big Sky,32,1019,154,293,140,248,14,45,129,175,97,200,297,59,56,43,78,90,451
4906,Josh Taylor,SR,2009-10,F,Eastern Kentucky,OVC,33,1061,161,341,84,144,77,197,52,72,38,100,138,55,27,17,45,101,451
4907,Ronald Timus,SR,2006-07,F,Morgan State,MEAC,31,1078,163,324,161,318,2,6,123,201,75,85,160,44,28,4,71,57,451
4908,Alex Tyus,SO,2008-09,F,Florida,SEC,36,944,195,330,195,330,0,0,61,89,76,146,222,24,17,28,42,65,451
4909,Ayinde Ubaka,JR,2005-06,G,University of California,Pac-10,31,1156,140,339,79,175,61,164,110,132,7,86,93,119,22,0,71,54,451
4910,Aaron Valdes,SO,2014-15,G,Hawaii,Big West,33,934,161,338,130,252,31,86,98,148,62,114,176,40,56,12,56,78,451
4911,Jamel Waters,SO,2013-14,G,Alabama State,SWAC,32,1114,146,377,117,277,29,100,130,170,25,79,104,194,58,1,76,70,451
4912,RJ White,SR,2016-17,C,North Carolina-Greensboro,Southern,35,889,181,329,165,278,16,51,73,120,74,159,233,43,30,39,70,114,451
4913,Brandon Young,SO,2011-12,G,DePaul,Big East,31,944,162,383,126,255,36,128,91,119,17,65,82,147,49,3,75,41,451
4914,Scott Bamforth,JR,2011-12,G,Weber State,Big Sky,31,995,134,305,57,113,77,192,105,120,17,95,112,74,28,0,57,66,450
4915,J.R. Blount,SR,2008-09,G,Loyola (IL),Horizon,32,1088,160,417,149,359,11,58,119,182,43,94,137,104,39,1,92,77,450
4916,Alphonso Dawson,SO,2008-09,G,Delaware,CAA,32,1043,171,442,121,265,50,177,58,80,60,109,169,34,27,19,54,82,450
4917,Bryant Dunston,SR,2007-08,F,Fordham,A-10,29,961,165,314,160,285,5,29,115,176,90,194,284,57,29,79,55,67,450
4918,Tyreek Duren,SO,2011-12,G,La Salle,A-10,34,1191,155,327,117,230,38,97,102,126,17,97,114,135,58,6,82,59,450
4919,Kyndall Dykes,SR,2008-09,F,New Orleans,Sun Belt,26,921,174,357,172,341,2,16,100,149,29,103,132,43,37,6,64,45,450
4920,Marcus Evans,JR,2018-19,G,Virginia Commonwealth,A-10,33,886,138,323,97,173,41,150,133,172,15,88,103,105,65,5,90,79,450
4921,Javorn Farrell,SR,2013-14,G,Texas-Rio Grande Valley,WAC,28,941,154,379,127,270,27,109,115,155,37,114,151,92,46,16,77,88,450
4922,John Gillon,JR,2015-16,G,Colorado State,MWC,34,1079,119,311,59,131,60,180,152,173,14,83,97,131,26,5,77,84,450
4923,Malcolm Hawkins,SR,2013-14,G,Norfolk State,MEAC,29,874,135,322,76,180,59,142,121,155,24,100,124,55,23,10,83,80,450
4926,Jordan Hill,SO,2007-08,F,Arizona,Pac-10,34,1001,184,297,184,297,0,0,82,120,84,186,270,27,17,56,72,105,450
4927,Scotty Hopson,SO,2009-10,G,Tennessee,SEC,37,1024,174,391,122,235,52,156,50,85,34,90,124,44,36,7,78,55,450
4928,Jordan Johnson,SR,2017-18,G,Nevada-Las Vegas,MWC,33,1132,124,290,75,164,49,126,153,182,15,78,93,199,39,8,90,76,450
4929,Shaquille Johnson,JR,2014-15,G,Longwood,Big South,33,1065,166,419,135,292,31,127,87,115,61,124,185,94,49,18,114,92,450
4930,Riley LaChance,SR,2017-18,G,Vanderbilt,SEC,32,1015,156,341,75,147,81,194,57,73,12,90,102,103,15,0,40,64,450
4931,Vic Law,SR,2018-19,F,Northwestern,Big Ten,30,1002,151,381,95,214,56,167,92,117,31,160,191,90,31,29,66,87,450
4932,Nick Mayo,FR,2015-16,F,Eastern Kentucky,OVC,31,923,179,295,164,268,15,27,77,96,48,105,153,34,20,34,63,71,450
4933,Mike Moser,SR,2013-14,F,Oregon,Pac-12,34,964,169,368,113,220,56,148,56,73,63,200,263,55,39,25,60,87,450
4934,Keiton Page,JR,2010-11,G,Oklahoma State,Big 12,34,1160,128,342,69,148,59,194,135,151,7,63,70,59,32,1,60,79,450
4935,Kevin Pangos,FR,2011-12,G,Gonzaga,WCC,33,1044,137,318,58,121,79,197,97,114,8,81,89,111,40,2,60,56,450
4936,Michael Roll,SR,2009-10,G,UCLA,Pac-10,32,1144,167,357,87,169,80,188,36,47,9,79,88,115,31,3,61,62,450
4937,Mike Rosario,SR,2012-13,G,Florida,SEC,36,1062,160,357,99,191,61,166,69,83,27,65,92,72,34,1,63,41,450
4938,Ben Simons,SR,2012-13,F,Drake,MVC,32,1106,153,351,75,156,78,195,66,75,4,112,116,58,29,8,59,68,450
4939,Jared Stohl,SR,2010-11,G,Portland,WCC,32,1042,138,319,47,106,91,213,83,93,23,54,77,58,27,0,35,30,450
4940,Andrew Strait,JR,2006-07,F,Montana,Big Sky,30,956,196,321,196,317,0,4,58,111,66,126,192,29,16,35,34,60,450
4941,Ryan Taylor,SO,2014-15,F,Marshall,CUSA,32,920,152,359,124,257,28,102,118,169,60,215,275,90,28,25,88,100,450
4942,Bilal Abdullah,SR,2007-08,G,Lafayette,Patriot,30,937,137,288,76,152,61,136,114,153,49,108,157,74,25,16,90,80,449
4943,Josh Adams,JR,2014-15,G,Wyoming,MWC,35,1176,146,334,99,189,47,145,110,148,21,93,114,126,48,8,90,74,449
4944,Trevon Allen,JR,2018-19,G,Idaho,Big Sky,32,968,173,407,128,269,45,138,58,79,11,122,133,98,22,4,63,51,449
4945,Remi Barry,SR,2014-15,F,New Mexico State,WAC,34,1095,154,337,111,239,43,98,98,128,46,115,161,35,19,6,61,62,449
4948,Ledarrius Brewer,FR,2017-18,G,Southeast Missouri State,OVC,31,912,152,362,81,166,71,196,74,100,14,104,118,40,29,16,57,66,449
4949,Aaron Broussard,JR,2010-11,F,Seattle,Ind,31,956,167,352,146,285,21,67,94,135,81,158,239,39,48,6,73,74,449
4950,Dejuan Clayton,SO,2018-19,G,Coppin State,MEAC,31,1066,142,356,111,227,31,129,134,179,9,81,90,119,28,2,87,59,449
4951,Phil Cofer,SR,2017-18,F,Florida State,ACC,35,1026,168,346,120,218,48,128,65,94,56,122,178,26,19,8,42,49,449
4952,Keaton Cole,SR,2011-12,G,Western Carolina,Southern,35,1055,143,335,27,61,116,274,47,67,16,39,55,52,46,0,52,60,449
4953,Seth Curry,JR,2011-12,G,Duke,ACC,34,1026,141,336,77,169,64,167,103,118,26,63,89,83,43,7,69,73,449
4954,Evan Fjeld,SR,2010-11,F,Vermont,AEC,31,926,184,339,182,330,2,9,79,120,62,133,195,38,15,58,67,71,449
4955,Kareem Grant,SR,2005-06,F,Tennessee State,OVC,28,946,172,337,115,190,57,147,48,57,34,80,114,35,28,5,39,74,449
4956,Rob Hampton,SR,2010-11,G,Norfolk State,MEAC,32,990,152,350,121,245,31,105,114,174,40,78,118,60,36,5,105,96,449
4957,Robbie Harman,SR,2009-10,G,Central Michigan,MAC,30,1014,148,350,43,105,105,245,48,63,11,56,67,91,56,5,60,80,449
4958,Jared Harper,SO,2017-18,G,Auburn,SEC,34,1038,111,308,50,136,61,172,166,202,14,68,82,185,40,1,72,63,449
4959,Lazar Hayward,SO,2007-08,F,Marquette,Big East,35,889,158,333,117,242,41,91,92,119,66,162,228,21,39,13,63,94,449
4960,Nathan Healy,SR,2012-13,F,Appalachian State,Southern,31,1085,168,347,116,212,52,135,61,76,55,184,239,42,59,45,51,80,449
4961,Sam Hinnant,SR,2008-09,G,East Carolina,CUSA,30,1047,138,358,53,123,85,235,88,106,22,87,109,58,17,2,46,49,449
4962,Dante Holmes,SR,2015-16,G,North Carolina Central,MEAC,29,975,151,374,77,177,74,197,73,106,28,113,141,52,29,2,60,98,449
4963,Markel Humphrey,SO,2006-07,F,Marshall,CUSA,32,1093,157,361,119,239,38,122,97,134,79,130,209,45,25,12,56,64,449
4964,DeWayne Jackson,SO,2010-11,F,Morgan State,MEAC,31,993,153,378,106,198,47,180,96,130,35,108,143,44,44,22,73,85,449
4965,Jalen Jones,SO,2012-13,G,Southern Methodist,CUSA,32,1036,165,326,157,303,8,23,111,152,107,140,247,32,39,23,71,111,449
4966,Daishon Knight,JR,2013-14,G,Illinois State,MVC,34,967,142,387,94,223,48,164,117,150,18,139,157,74,42,4,77,52,449
4967,Scott Machado,SR,2011-12,G,Iona,MAAC,33,1171,155,313,115,214,40,99,99,122,30,133,163,327,53,7,108,86,449
4968,Anthony Morrow,SO,2005-06,G,Georgia Tech,ACC,28,901,154,348,76,166,78,182,63,71,51,76,127,46,30,5,64,72,449
4969,Mamadou Ndiaye,JR,2015-16,C,UC-Irvine,Big West,37,857,169,251,169,251,0,0,111,176,74,193,267,24,6,87,83,92,449
4970,Devon Peltier,SR,2010-11,G,Cal State Fullerton,Big West,31,986,144,316,72,139,72,177,89,99,16,37,53,31,20,1,56,73,449
4971,Devonta Pollard,SR,2015-16,F,Houston,AAC,32,951,156,326,155,324,1,2,136,182,59,122,181,51,29,20,50,76,449
4972,Jared Sam,JR,2016-17,F,Southern,SWAC,33,1077,145,246,145,245,0,1,159,208,82,163,245,34,28,23,62,88,449
4973,Brenton Scott,SR,2017-18,G,Indiana State,MVC,31,1018,156,390,94,206,62,184,75,105,14,163,177,73,53,6,78,78,449
4974,Russ Smith,SO,2011-12,G,Louisville,Big East,39,837,149,419,108,285,41,134,110,144,27,71,98,76,87,1,90,110,449
4975,Alexander Starr,SR,2006-07,F,Centenary (LA),Mid-Cont,31,,159,302,140,259,19,43,112,135,,,182,92,43,13,,,449
4976,Lance Tejada,SR,2018-19,G,Lehigh,Patriot,31,937,150,360,65,156,85,204,64,81,11,64,75,101,26,1,69,91,449
4977,James Washington,SR,2010-11,G,Middle Tennessee,Sun Belt,32,1121,122,302,50,120,72,182,133,154,10,62,72,91,52,1,74,75,449
4978,Alan Williams,SR,2014-15,C,UC-Santa Barbara,Big West,26,847,160,349,160,346,0,3,129,168,86,222,308,45,31,47,51,70,449
4979,Brandon Worthy,JR,2005-06,G,Loyola Marymount,WCC,30,998,131,323,106,254,25,69,162,197,37,69,106,130,53,8,82,91,449
4980,Chaisson Allen,JR,2009-10,G,Northeastern,CAA,33,1167,151,343,82,169,69,174,77,104,35,121,156,118,51,1,75,53,448
4981,James Augustine,SR,2005-06,F,Illinois,Big Ten,33,1079,174,279,173,277,1,2,99,152,100,200,300,59,47,24,67,84,448
4982,Lamonte Bearden,JR,2017-18,G,Western Kentucky,CUSA,38,1053,151,317,132,256,19,61,127,154,21,67,88,131,65,6,92,82,448
4983,Jordan Bitzer,SR,2009-10,G,Central Michigan,MAC,30,1015,143,353,71,174,72,179,90,105,16,134,150,66,45,13,57,76,448
4984,Ronnie Boyce III,SR,2016-17,G,San Francisco,WCC,33,624,168,371,128,231,40,140,72,99,28,105,133,47,28,8,68,37,448
4985,Zack Bryant,FR,2017-18,G,Alabama-Birmingham,CUSA,33,1056,162,355,132,261,30,94,94,125,14,91,105,101,37,7,73,85,448
4986,Bruce Carter,SR,2007-08,F,Murray State,OVC,31,854,161,331,117,217,44,114,82,100,48,125,173,60,32,7,55,93,448
4987,Derrick Favors,FR,2009-10,F,Georgia Tech,ACC,36,989,179,293,179,292,0,1,90,143,108,195,303,37,32,74,90,94,448
4990,Chase Fischer,JR,2014-15,G,Brigham Young,WCC,34,914,147,351,44,103,103,248,51,65,10,64,74,67,25,2,49,50,448
4991,Greg Gantt,SO,2010-11,G,Florida Atlantic,Sun Belt,32,967,166,362,108,180,58,182,58,83,27,97,124,29,23,0,38,54,448
4992,Nick Garth,JR,2017-18,G,Lamar,Southland,33,885,143,346,64,137,79,209,83,99,16,61,77,54,20,0,42,52,448
4993,Louis Graham,JR,2006-07,F,Georgia Southern,Southern,31,818,185,351,183,337,2,14,76,118,70,185,255,17,29,46,80,91,448
4994,Kevyn Green,SR,2007-08,G,Southeastern Louisiana,Southland,29,907,145,352,65,151,80,201,78,107,28,104,132,29,18,9,66,58,448
4995,Justin Greene,SR,2011-12,F,Kent State,MAC,32,975,162,328,162,328,0,0,124,171,68,149,217,47,37,27,101,85,448
4996,Noah Horchler,JR,2018-19,F,North Florida,A-Sun,28,874,192,357,171,286,21,71,43,84,69,192,261,36,26,48,58,74,448
4997,Mike Hughes,SO,2015-16,G,Georgia Southern,Sun Belt,30,907,141,326,74,152,67,174,99,136,26,116,142,48,63,10,62,77,448
4998,Yassin Idbihi,JR,2005-06,F,Buffalo,MAC,32,924,156,333,132,266,24,67,112,144,92,128,220,52,20,24,92,90,448
4999,Clarence Jackson,JR,2009-10,G,Siena,MAAC,33,882,154,360,83,161,71,199,69,95,15,67,82,27,58,12,45,63,448
5000,Stanton Kidd,JR,2012-13,F,North Carolina Central,MEAC,31,997,173,313,154,262,19,51,83,119,75,139,214,31,32,18,64,85,448
5001,Tyler Lydon,SO,2016-17,F,Syracuse,ACC,34,1227,151,319,102,195,49,124,97,116,79,215,294,70,35,49,59,84,448
5002,Jordan Mathews,SO,2014-15,G,University of California,Pac-12,33,1027,143,321,73,163,70,158,92,117,18,95,113,46,20,1,50,64,448
5003,Tywain McKee,FR,2005-06,G,Coppin State,MEAC,29,915,154,365,107,237,47,128,93,122,41,82,123,71,46,3,88,58,448
5004,Alex McLean,JR,2006-07,F,Liberty,Big South,31,997,185,340,183,334,2,6,76,122,94,181,275,31,14,20,72,62,448
5005,Mike Morsell,SR,2017-18,G,Towson,CAA,32,899,162,369,111,222,51,147,73,101,46,88,134,30,33,14,56,94,448
5006,Jeffery Moss,SO,2013-14,F,Murray State,OVC,34,1170,147,337,89,184,58,153,96,120,24,90,114,72,15,10,42,72,448
5007,Jake Odum,JR,2012-13,G,Indiana State,MVC,33,1068,127,267,108,216,19,51,175,227,24,123,147,151,48,10,90,74,448
5008,A.J. Ogilvy,SO,2008-09,C,Vanderbilt,SEC,29,799,152,280,145,253,7,27,137,196,51,156,207,37,25,48,80,78,448
5009,Brett Olson,JR,2013-14,G,Denver,Summit,31,1141,144,302,76,147,68,155,92,102,8,96,104,108,34,3,61,87,448
5012,Colbey Ross,FR,2017-18,G,Pepperdine,WCC,32,1017,151,325,110,229,41,96,105,128,11,84,95,179,33,5,88,77,448
5013,Vincent Simpson,SR,2009-10,G,Hampton,MEAC,32,931,155,384,94,184,61,200,77,105,14,53,67,84,52,1,99,63,448
5014,Brian Stafford,SR,2011-12,G,Denver,Sun Belt,31,1035,146,293,71,129,75,164,81,99,14,41,55,65,35,5,40,65,448
5015,Jordan Sugars,JR,2010-11,G,Navy,Patriot,28,954,154,381,86,178,68,203,72,99,38,130,168,35,38,2,68,53,448
5016,Jason Thompson,SO,2005-06,C,Rider,MAAC,27,858,159,291,152,270,7,21,123,175,78,148,226,43,24,48,80,86,448
5017,B.J. Tyson,SR,2017-18,G,East Carolina,AAC,30,1093,162,394,120,250,42,144,82,99,25,105,130,81,24,7,58,60,448
5018,Chris Udofia,SO,2011-12,F,Denver,Sun Belt,31,928,165,309,144,237,21,72,97,134,51,110,161,82,22,72,74,97,448
5019,Cody Wichmann,SR,2016-17,G,Milwaukee,Horizon,35,1149,149,367,52,101,97,266,53,67,13,124,137,54,28,2,34,80,448
5020,Musa Abdul-Aleem,SR,2014-15,G,Troy,Sun Belt,28,811,151,341,81,152,70,189,75,95,25,109,134,20,33,1,53,60,447
5021,Bryon Allen,SR,2013-14,G,George Mason,A-10,29,985,156,346,113,236,43,110,92,110,28,86,114,87,28,1,61,68,447
5022,Maurice Barrow,SR,2013-14,F,Fairfield,MAAC,32,943,149,342,109,219,40,123,109,147,53,106,159,39,28,24,60,91,447
5023,Earl Brown,JR,2013-14,F,Saint Francis (PA),NEC,31,1032,181,341,178,331,3,10,82,141,82,166,248,49,22,34,80,74,447
5024,Jamaya Burr,JR,2015-16,G,McNeese State,Southland,29,1048,127,309,93,216,34,93,159,207,23,85,108,104,44,1,98,64,447
5025,Nico Clareth,FR,2015-16,G,Siena,MAAC,34,905,174,379,119,207,55,172,44,74,33,76,109,75,54,20,77,86,447
5026,Javier Duren,SR,2014-15,G,Yale,Ivy,32,1004,132,328,80,185,52,143,131,167,26,150,176,126,41,9,87,80,447
5027,Nick Emery,SO,2016-17,G,Brigham Young,WCC,34,1024,152,366,77,164,75,202,68,82,4,99,103,82,55,9,69,100,447
5028,George Fant,SO,2012-13,F,Western Kentucky,Sun Belt,35,1016,163,338,163,338,0,0,121,200,90,142,232,24,26,39,95,108,447
5029,Eric Ferguson,JR,2012-13,F,Georgia Southern,Southern,33,976,160,335,139,271,21,64,106,158,56,147,203,33,51,26,80,98,447
5030,Chase Fieler,JR,2012-13,F,Florida Gulf Coast,A-Sun,37,1031,169,300,135,211,34,89,75,102,80,121,201,58,39,49,62,104,447
5031,Danny Green,JR,2007-08,F,North Carolina,ACC,39,869,161,343,105,193,56,150,69,79,67,126,193,77,48,46,74,91,447
5034,Marcus Hall,SR,2007-08,G,Colorado,Big 12,32,1202,171,359,118,220,53,139,52,77,29,95,124,128,58,7,71,61,447
5035,Kason Harrell,JR,2017-18,G,Purdue-Fort Wayne,Summit,33,1015,160,365,71,123,89,242,38,46,21,75,96,44,37,17,61,74,447
5036,Shaquille Harrison,JR,2014-15,G,Tulsa,AAC,34,1069,163,363,150,308,13,55,108,171,40,133,173,125,67,20,81,83,447
5037,Calvin Hermanson,JR,2016-17,F,Saint Mary's (CA),WCC,34,971,155,314,67,110,88,204,49,60,23,78,101,31,16,6,33,79,447
5038,Jerome Hill,SO,2013-14,F,Gardner-Webb,Big South,31,909,154,314,154,312,0,2,139,215,102,162,264,40,25,14,62,76,447
5039,Anthony Humpty Hitchens,SR,2011-12,G,James Madison,CAA,30,1095,158,374,76,163,82,211,49,75,10,58,68,111,39,1,89,86,447
5040,Caleb Homesley,JR,2018-19,G,Liberty,A-Sun,36,1002,179,388,123,208,56,180,33,47,18,182,200,96,26,22,50,68,447
5041,Darryl Hudson,SR,2006-07,F,Howard,MEAC,31,985,142,274,113,209,29,65,134,197,59,119,178,56,28,6,83,63,447
5042,Sam Hunt,SO,2015-16,G,North Carolina A&T,MEAC,29,967,134,345,68,150,66,195,113,125,8,51,59,61,20,1,69,82,447
5043,Darnell Jackson,SR,2007-08,F,Kansas,Big 12,40,971,171,273,169,267,2,6,103,149,81,186,267,43,31,19,51,90,447
5044,Melvin Johnson,JR,2014-15,G,Virginia Commonwealth,A-10,36,1003,155,385,69,148,86,237,51,65,17,53,70,65,37,3,36,56,447
5045,Gordon Klaiber,SR,2005-06,F,Fairleigh Dickinson,NEC,30,970,148,366,99,223,49,143,102,156,48,126,174,53,48,41,59,81,447
5046,Anthony Lamb,FR,2016-17,F,Vermont,AEC,35,787,171,334,145,271,26,63,79,106,68,124,192,24,27,43,70,98,447
5047,Stephane Lasme,SR,2006-07,F,Massachusetts,A-10,33,1010,165,270,165,270,0,0,117,188,126,189,315,28,29,168,79,111,447
5048,Kenny Lawson,JR,2009-10,C,Creighton,MVC,34,821,163,303,155,290,8,13,113,138,63,167,230,22,14,50,46,65,447
5049,Lonnie McClanahan,JR,2013-14,G,Texas-Arlington,Sun Belt,32,856,149,335,148,330,1,5,148,200,36,95,131,113,29,1,105,86,447
5050,Jason McManamen,JR,2015-16,G,Wyoming,MWC,32,1107,136,296,44,87,92,209,83,110,10,87,97,49,13,3,41,88,447
5051,Harouna Mutombo,FR,2008-09,G,Western Carolina,Southern,31,944,167,359,138,266,29,93,84,135,55,87,142,68,56,16,66,74,447
5052,Anthony Nelson,SR,2010-11,G,Niagara,MAAC,29,1081,127,347,89,201,38,146,155,221,48,96,144,147,98,2,105,57,447
5053,Sa'eed Nelson,FR,2016-17,G,American,Patriot,30,1136,164,372,145,285,19,87,100,178,20,113,133,82,72,4,86,82,447
5056,Obie Nwadike,SR,2006-07,F,Central Connecticut State,NEC,31,1061,128,270,128,269,0,1,191,251,136,195,331,43,33,1,80,99,447
5057,Dererk Pardon,SR,2018-19,C,Northwestern,Big Ten,32,1047,173,303,167,275,6,28,95,139,96,152,248,58,27,30,45,85,447
5058,Jordan Reed,SO,2013-14,G,Binghamton,AEC,29,961,134,324,120,285,14,39,165,231,72,186,258,36,45,23,78,87,447
5059,Clarke Rosenberg,JR,2013-14,G,Chicago State,WAC,32,989,154,340,129,266,25,74,114,152,39,82,121,83,46,7,74,84,447
5060,Nick Russell,JR,2012-13,G,Southern Methodist,CUSA,32,1159,178,436,152,354,26,82,65,89,13,102,115,138,48,8,121,60,447
5061,Dante Scott,JR,2017-18,SF,Mississippi Valley State,SWAC,30,948,162,386,118,267,44,119,79,102,51,116,167,57,15,9,76,74,447
5062,Montrael Scott,SR,2014-15,G,Prairie View,SWAC,29,993,163,384,110,217,53,167,68,91,28,96,124,51,41,1,65,61,447
5063,Tanoris Shepard,SR,2005-06,G,Idaho,WAC,29,1043,155,366,107,224,48,142,89,125,16,95,111,106,41,4,88,53,447
5064,Chase Tapley,SR,2012-13,G,San Diego State,MWC,33,1016,162,378,92,192,70,186,53,66,10,95,105,90,46,18,43,55,447
5065,Mark Tollefsen,JR,2014-15,F,San Francisco,WCC,32,1001,176,329,134,218,42,111,53,82,56,118,174,48,27,27,35,58,447
5066,Erving Walker,SR,2011-12,G,Florida,SEC,37,1158,134,340,65,150,69,190,110,135,18,88,106,170,37,0,76,56,447
5067,Bryce Washington,JR,2016-17,F,Louisiana,Sun Belt,33,1159,173,287,173,281,0,6,101,158,132,237,369,70,41,25,65,65,447
5068,Hassan Whiteside,FR,2009-10,C,Marshall,CUSA,34,889,167,319,164,314,3,5,110,187,92,211,303,10,19,182,64,82,447
5069,Scottie Wilbekin,SR,2013-14,G,Florida,SEC,34,1150,140,348,73,176,67,172,100,138,6,77,83,123,56,0,58,59,447
5070,Eric Williams Jr.,SO,2018-19,G,Duquesne,A-10,32,987,151,356,95,205,56,151,89,119,93,149,242,45,36,7,55,62,447
5071,Nic Wise,SR,2009-10,G,Arizona,Pac-10,31,1021,130,337,80,198,50,139,137,156,7,95,102,103,54,2,73,72,447
5072,Scott Wood,JR,2011-12,F,North Carolina State,ACC,36,1183,132,310,37,78,95,232,88,97,11,71,82,58,26,23,39,82,447
5073,Raheem Appleby,FR,2011-12,G,Louisiana Tech,WAC,32,892,173,368,133,268,40,100,60,84,31,47,78,37,35,2,44,46,446
5074,Brent Benson,SR,2008-09,G,Texas State,Southland,29,745,138,309,43,92,95,217,75,109,17,63,80,43,20,4,48,86,446
5075,Darrell Brown,SO,2017-18,G,Bradley,MVC,33,1051,141,400,92,262,49,138,115,143,7,70,77,142,25,0,95,69,446
5076,Devin Brown,JR,2010-11,G,Holy Cross,Patriot,29,852,141,339,81,172,60,167,104,129,7,55,62,42,17,1,58,60,446
5077,Jomaru Brown,FR,2018-19,G,Eastern Kentucky,OVC,31,770,158,360,120,245,38,115,92,136,20,73,93,67,60,2,85,95,446
5078,Brian Butch,SR,2007-08,F,Wisconsin,Big Ten,36,885,162,355,137,274,25,81,97,150,77,160,237,29,20,29,51,69,446
5079,Folarin Campbell,JR,2006-07,G,George Mason,CAA,32,1045,139,370,88,204,51,166,117,162,24,102,126,122,41,10,97,85,446
5080,Colin Chiverton,JR,2011-12,F,Eastern Washington,Big Sky,32,706,147,401,59,184,88,217,64,81,17,50,67,17,24,13,32,73,446
5081,Dylon Cormier,SR,2013-14,G,Loyola (MD),Patriot,21,727,150,325,130,255,20,70,126,191,63,59,122,38,46,9,42,52,446
5082,Jaye Crockett,SR,2013-14,F,Texas Tech,Big 12,32,941,170,329,150,266,20,63,86,104,68,138,206,38,32,12,58,74,446
5083,Paul Crosby,SR,2011-12,C,Mississippi Valley State,SWAC,34,1116,153,389,117,266,36,123,104,144,89,161,250,56,53,28,85,106,446
5084,Richard Delk,JR,2008-09,G,Troy,Sun Belt,32,1031,179,368,133,237,46,131,42,79,42,112,154,79,35,12,70,77,446
5085,David DiLeo,SO,2017-18,F,Central Michigan,MAC,36,1210,140,359,44,84,96,275,70,87,67,172,239,50,34,9,27,64,446
5086,Ousmane Drame,SR,2014-15,F,Quinnipiac,MAAC,30,873,158,347,157,344,1,3,129,160,108,227,335,31,21,88,69,89,446
5087,Frankie Ferrari,JR,2017-18,G,San Francisco,WCC,39,1119,157,382,87,202,70,180,62,78,8,89,97,179,38,0,69,72,446
5088,Shep Garner,SR,2017-18,G,Penn State,Big Ten,39,1279,146,329,26,52,120,277,34,41,8,72,80,52,35,4,47,83,446
5089,Chris Gaston,SO,2010-11,F,Fordham,A-10,28,950,178,381,178,379,0,2,90,174,96,220,316,38,26,41,97,81,446
5090,Chris Gradnigo,SR,2011-12,F,Coastal Carolina,Big South,30,836,172,377,133,264,39,113,63,79,44,143,187,31,19,25,68,78,446
5091,Josh Hawkinson,JR,2015-16,F,Washington State,Pac-12,29,967,170,313,155,274,15,39,91,117,45,276,321,44,20,31,59,60,446
5092,ShanQuan Hemphill,JR,2018-19,F,Green Bay,Horizon,38,1061,188,356,188,354,0,2,70,147,64,148,212,58,40,20,72,74,446
5093,Victor Joseph,SR,2017-18,G,Cal Poly,Big West,31,913,147,365,83,188,64,177,88,100,18,61,79,59,26,5,59,64,446
5094,DaVonte Lacy,JR,2013-14,G,Washington State,Pac-12,23,787,132,308,56,113,76,195,106,127,22,75,97,33,28,3,47,57,446
5095,Andrew Lawrence,SR,2012-13,G,College of Charleston,Southern,33,1075,131,328,72,159,59,169,125,163,11,89,100,122,44,9,86,58,446
5098,David Lighty,SR,2010-11,G,Ohio State,Big Ten,37,1186,153,327,102,208,51,119,89,142,49,99,148,122,55,17,58,72,446
5099,Geno Luzcando,SO,2015-16,G,Idaho State,Big Sky,31,950,151,300,114,197,37,103,107,150,31,95,126,41,61,3,84,91,446
5100,Ray McCallum,FR,2010-11,G,Detroit Mercy,Horizon,33,1098,140,318,115,238,25,80,141,204,46,110,156,161,54,5,85,70,446
5101,Quinn McDowell,SO,2009-10,G,William & Mary,CAA,32,1065,145,294,87,158,58,136,98,122,38,101,139,41,19,3,38,75,446
5102,Amadi McKenzie,JR,2006-07,F,Tennessee Tech,OVC,32,875,163,268,162,260,1,8,119,185,101,147,248,33,38,17,60,100,446
5103,Marshun Newell,SR,2014-15,G,Tennessee-Martin,OVC,34,1199,146,354,77,184,69,170,85,112,52,182,234,91,35,3,75,59,446
5104,Jake Odum,SR,2013-14,G,Indiana State,MVC,34,1096,124,291,102,221,22,70,176,229,20,123,143,155,35,5,63,66,446
5105,Kruize Pinkins,SR,2014-15,F,San Francisco,WCC,32,837,154,316,122,234,32,82,106,163,70,106,176,44,22,13,57,99,446
5106,Chase Plummer,SO,2011-12,F,Maryland-Baltimore County,AEC,29,821,155,374,138,321,17,53,119,180,70,144,214,40,40,9,114,84,446
5107,Tajuan Porter,SO,2007-08,G,Oregon,Pac-10,32,1036,152,393,69,160,83,233,59,75,16,59,75,78,15,4,75,73,446
5108,Zaynah Robinson,JR,2016-17,G,Norfolk State,MEAC,33,1176,148,390,89,211,59,179,91,117,12,101,113,148,53,4,55,69,446
5109,Evan Roquemore,FR,2010-11,G,Santa Clara,WCC,38,1193,115,311,58,167,57,144,159,193,23,114,137,139,36,12,88,89,446
5110,Edward Stephens,SO,2015-16,G,South Carolina State,MEAC,34,1033,149,341,59,118,90,223,58,69,12,70,82,56,24,1,33,60,446
5111,Christian Terrell,SO,2015-16,G,Florida Gulf Coast,A-Sun,35,1021,159,357,112,226,47,131,81,113,38,139,177,82,42,13,46,67,446
5112,Tre'Shawn Thurman,SO,2015-16,F,Omaha,Summit,32,878,172,321,159,274,13,47,89,138,62,151,213,43,25,35,52,93,446
5113,Ryan Tillema,SR,2008-09,G,Green Bay,Horizon,26,701,138,297,64,134,74,163,96,126,25,92,117,38,20,12,34,67,446
5114,Julian Washburn,JR,2013-14,F,Texas-El Paso,CUSA,34,1170,162,380,114,248,48,132,74,94,20,100,120,85,33,13,49,51,446
5115,Kobe Webster,FR,2017-18,G,Western Illinois,Summit,28,935,165,383,106,222,59,161,57,73,10,106,116,97,20,3,63,44,446
5116,Will Whittington,JR,2005-06,G,Marist,MAAC,29,947,134,326,31,72,103,254,75,95,12,67,79,45,18,4,41,50,446
5117,Ryan Willen,SR,2011-12,F,Lafayette,Patriot,31,889,129,291,99,207,30,84,158,193,57,108,165,55,30,8,63,82,446
5120,Shizz Alston Jr.,FR,2016-17,G,Temple,AAC,32,1164,156,382,89,188,67,194,66,76,20,96,116,131,53,12,48,80,445
5121,Jordan Bohannon,SO,2017-18,G,Iowa,Big Ten,33,1050,137,324,41,101,96,223,75,83,4,70,74,178,22,0,68,59,445
5122,Pat Calathes,JR,2006-07,G,Saint Joseph's,A-10,32,1021,144,316,97,204,47,112,110,130,63,165,228,116,17,28,96,73,445
5123,David Carson,SR,2008-09,G,Purdue-Fort Wayne,Summit,30,955,151,366,129,293,22,73,121,155,44,122,166,55,13,7,72,93,445
5124,Markeith Cummings,SR,2012-13,F,Kennesaw State,A-Sun,27,890,159,350,137,278,22,72,105,148,47,71,118,39,27,4,69,87,445
5125,JamesOn Curry,SO,2005-06,G,Oklahoma State,Big 12,33,1124,159,400,95,230,64,170,63,90,13,80,93,132,38,6,110,68,445
5126,Damyean Dotson,JR,2015-16,G,Houston,AAC,32,991,164,324,102,155,62,169,55,66,62,155,217,40,22,6,33,61,445
5127,Wayne Ellington,FR,2006-07,G,North Carolina,ACC,38,909,164,379,98,201,66,178,51,61,28,81,109,79,29,1,47,49,445
5128,Frank Gaines,SO,2010-11,G,Purdue-Fort Wayne,Summit,30,822,151,306,123,220,28,86,115,151,42,143,185,25,28,20,43,85,445
5129,Marcus Gilbert,SO,2013-14,F,Fairfield,MAAC,32,1042,143,353,70,154,73,199,86,112,28,136,164,50,20,14,91,92,445
5130,Ruben Guerrero,SR,2018-19,C,Samford,Southern,33,988,187,306,187,306,0,0,71,109,108,169,277,20,19,69,67,95,445
5131,Blake Hamilton,JR,2015-16,G,Buffalo,MAC,34,901,152,334,99,194,53,140,88,119,45,195,240,85,47,12,97,96,445
5132,Tyrone Hanson,SR,2010-11,G,Jackson State,SWAC,32,962,151,354,69,147,82,207,61,85,24,102,126,70,27,15,75,61,445
5133,Paul Harris,JR,2008-09,F,Syracuse,Big East,37,1130,154,312,144,268,10,44,127,168,89,209,298,80,38,26,78,71,445
5134,Brady Heslip,SR,2013-14,G,Baylor,Big 12,38,1042,133,295,15,41,118,254,61,76,11,37,48,33,20,0,14,45,445
5135,Quinton Hosley,SR,2006-07,G,Fresno State,WAC,32,1064,140,335,102,217,38,118,127,189,84,200,284,47,42,19,86,89,445
5136,Richard Howell,SR,2012-13,F,North Carolina State,ACC,35,1105,183,321,183,321,0,0,79,122,131,249,380,60,36,32,57,105,445
5137,Terone Johnson,JR,2012-13,G,Purdue,Big Ten,33,1060,171,425,134,318,37,107,66,106,42,112,154,95,17,6,66,68,445
5138,Perry Jones,SO,2011-12,F,Baylor,Big 12,33,1013,182,364,172,331,10,33,71,102,89,163,252,42,28,20,56,77,445
5139,Tony Lee,JR,2006-07,G,Robert Morris,NEC,28,947,169,285,150,224,19,61,88,130,66,104,170,123,77,6,96,69,445
5142,Dakota Mathias,SR,2017-18,G,Purdue,Big Ten,37,1161,151,320,55,114,96,206,47,57,5,145,150,146,46,9,54,64,445
5143,Geoff McCammon,SR,2010-11,G,Loyola (IL),Horizon,31,964,147,358,62,154,85,204,66,79,13,81,94,32,27,6,59,55,445
5144,Byron Mulkey,SR,2010-11,G,Buffalo,MAC,34,1192,146,350,93,210,53,140,100,128,8,123,131,154,85,1,83,74,445
5145,Robert Olson,SR,2012-13,G,Loyola (MD),MAAC,35,1141,159,413,86,186,73,227,54,74,41,114,155,74,37,7,56,93,445
5146,Arinze Onuaku,JR,2007-08,C,Syracuse,Big East,35,1070,186,296,186,296,0,0,73,164,114,170,284,26,36,47,67,108,445
5147,Pele Paelay,SR,2005-06,G,Coastal Carolina,Big South,30,971,153,343,104,207,49,136,90,121,46,109,155,80,34,10,54,52,445
5148,Omar Prewitt,SO,2014-15,G,William & Mary,CAA,33,1089,152,331,102,184,50,147,91,130,16,128,144,84,40,27,63,77,445
5149,Joe Reitz,JR,2006-07,C,Western Michigan,MAC,32,906,150,268,150,268,0,0,145,219,100,175,275,14,20,2,72,91,445
5150,Justin Rutty,SO,2008-09,F,Quinnipiac,NEC,30,968,194,321,194,321,0,0,57,136,137,158,295,27,19,30,64,83,445
5151,Damian Saunders,SO,2008-09,F,Duquesne,A-10,34,1176,179,328,142,220,37,108,50,98,84,174,258,77,71,83,68,103,445
5152,Myles Stephens,JR,2017-18,G,Princeton,Ivy,29,998,171,329,131,232,40,97,63,92,40,142,182,41,13,26,64,61,445
5153,Barry Stewart,JR,2008-09,G,Mississippi State,SEC,36,1138,126,343,54,146,72,197,121,156,28,107,135,66,46,10,66,84,445
5154,Andrew Warren,JR,2009-10,G,Bradley,MVC,31,1041,142,353,81,199,61,154,100,115,28,111,139,47,26,3,63,65,445
5155,Corey Wilford,SR,2012-13,G,Southeast Missouri State,OVC,31,890,156,343,74,150,82,193,51,71,27,85,112,69,24,8,55,66,445
5156,Thaddeus Young,FR,2006-07,F,Georgia Tech,ACC,31,917,177,370,138,277,39,93,52,70,72,79,151,63,39,12,67,61,445
5157,Omer Yurtseven,SO,2017-18,C,North Carolina State,ACC,33,786,187,327,165,283,22,44,49,80,91,131,222,15,16,60,38,99,445
5158,Josh Alexander,SR,2008-09,G,Stephen F. Austin,Southland,31,1051,142,363,70,151,72,212,88,113,73,94,167,29,36,15,52,71,444
5159,Eric Atkins,SR,2013-14,G,Notre Dame,ACC,32,1211,159,375,98,210,61,165,65,96,28,60,88,156,39,5,61,73,444
5160,Marquiz Baker,JR,2010-11,G,Alcorn State,SWAC,28,793,128,382,71,219,57,163,131,168,29,65,94,31,45,0,65,56,444
5161,Tre Bowman,SR,2013-14,G,Iona,MAAC,32,1004,156,298,88,128,68,170,64,81,28,115,143,40,31,6,24,44,444
5164,Kenny Boynton,SR,2012-13,G,Florida,SEC,37,1170,145,368,74,147,71,221,83,101,19,91,110,102,31,3,48,31,444
5165,Keith Braxton,FR,2016-17,G,Saint Francis (PA),NEC,34,1136,164,308,139,251,25,57,91,119,69,224,293,107,49,13,85,69,444
5166,Derrick Bruce,JR,2017-18,G,Texas Southern,SWAC,32,1057,143,363,59,150,84,213,74,90,18,103,121,63,37,8,71,71,444
5167,Melvin Buckley,SR,2006-07,F,South Florida,Big East,30,1070,151,391,72,163,79,228,63,83,32,114,146,31,20,9,73,65,444
5168,Noah Dickerson,SR,2018-19,F,Washington,Pac-12,36,931,145,261,145,260,0,1,154,224,87,183,270,32,37,22,91,106,444
5169,Damiyne Durham,SO,2016-17,G,Cal State Bakersfield,WAC,35,742,163,423,66,137,97,286,21,33,28,79,107,27,44,13,51,34,444
5170,Randal Falker,JR,2006-07,F,Southern Illinois,MVC,36,1062,162,272,162,272,0,0,120,221,92,185,277,43,27,75,91,112,444
5171,Savion Flagg,SO,2018-19,G,Texas A&M,SEC,32,1112,171,366,126,233,45,133,57,86,68,179,247,73,22,11,82,42,444
5172,Justin Forrest,FR,2017-18,G,Appalachian State,Sun Belt,33,924,147,399,81,181,66,218,84,126,10,85,95,67,42,2,95,86,444
5173,Jarvis Garner,SR,2012-13,F,Central Arkansas,Southland,28,845,156,374,103,219,53,155,79,109,39,158,197,36,31,12,68,67,444
5174,Christavious Gill,JR,2015-16,G,New Orleans,Southland,30,908,140,372,76,187,64,185,100,120,26,48,74,83,57,3,51,55,444
5175,Jalen Hayes,SO,2015-16,F,Oakland,Horizon,34,1041,168,320,165,311,3,9,105,144,74,218,292,26,32,17,50,100,444
5176,Tamir Jackson,SO,2010-11,G,Rice,CUSA,32,1064,143,338,119,270,24,68,134,183,25,62,87,115,41,0,87,81,444
5177,Kedren Johnson,SO,2012-13,G,Vanderbilt,SEC,33,1047,145,355,90,198,55,157,99,137,15,102,117,119,34,17,94,64,444
5178,Jalen Jones,JR,2015-16,G,Texas-Arlington,Sun Belt,35,877,155,337,105,197,50,140,84,104,67,115,182,43,29,1,29,75,444
5179,Mathieu Kamba,JR,2016-17,G,Central Arkansas,Southland,32,1001,167,315,159,295,8,20,102,172,90,125,215,56,25,16,71,92,444
5180,Levi Knutson,SR,2010-11,G,Colorado,Big 12,38,1019,158,312,77,141,81,171,47,52,23,87,110,38,22,2,31,70,444
5181,Craig Moore,SR,2008-09,G,Northwestern,Big Ten,31,1105,142,336,32,65,110,271,50,63,19,80,99,84,41,8,56,73,444
5182,Obi Muonelo,JR,2008-09,G,Oklahoma State,Big 12,35,1053,158,380,70,159,88,221,40,59,44,208,252,57,33,1,52,76,444
5183,Gary Neal,JR,2005-06,G,Towson,CAA,17,600,138,310,76,157,62,153,106,132,12,54,66,49,30,3,60,48,444
5184,Matt O'Leary,SR,2016-17,F,IUPUI,Summit,32,956,161,320,93,168,68,152,54,74,31,165,196,71,31,14,52,67,444
5185,Cameron Oluyitan,JR,2018-19,G,Southern Utah,Big Sky,34,1098,153,343,102,202,51,141,87,116,14,129,143,77,38,13,86,82,444
5186,Kendall Pollard,SO,2014-15,F,Dayton,A-10,35,1020,159,288,156,279,3,9,123,212,39,148,187,37,30,32,85,116,444
5187,Paul Reed,SO,2018-19,F,DePaul,Big East,36,967,176,313,161,276,15,37,77,100,98,207,305,34,40,55,64,92,444
5188,Brandon Rush,FR,2005-06,G,Kansas,Big 12,33,1047,170,359,120,253,50,106,54,71,48,147,195,65,29,23,83,39,444
5189,Tomas Sanchez,SR,2013-14,G,Idaho State,Big Sky,29,1099,126,325,67,165,59,160,133,160,16,68,84,125,50,3,92,61,444
5190,Justin Sears,JR,2014-15,F,Yale,Ivy,31,1012,154,301,152,295,2,6,134,194,94,140,234,48,34,73,85,77,444
5191,Raymond Spalding,JR,2017-18,F,Louisville,ACC,36,995,183,337,178,318,5,19,73,114,113,199,312,46,54,62,61,107,444
5192,Ronald Steele,SO,2005-06,G,Alabama,SEC,31,1191,133,320,79,189,54,131,124,139,21,93,114,132,45,8,83,46,444
5193,Ben Stywall,SR,2009-10,F,North Carolina-Greensboro,Southern,31,1051,161,331,160,323,1,8,121,180,131,192,323,32,48,18,79,90,444
5194,Justice Sueing,SO,2018-19,F,University of California,Pac-12,31,1070,140,324,105,208,35,116,129,165,46,140,186,61,52,15,53,78,444
5195,Isaiah Taylor,FR,2013-14,G,Texas,Big 12,35,1055,144,368,139,349,5,19,151,202,10,105,115,141,37,3,83,90,444
5196,Jonathan Thompson,SR,2012-13,G,Rider,MAAC,34,1152,146,293,97,173,49,120,103,135,34,98,132,105,51,22,70,55,444
5197,Hank Thorns,SR,2011-12,G,Texas Christian,MWC,33,1121,140,370,66,181,74,189,90,120,18,75,93,152,44,1,104,83,444
5198,Michael Tveidt,SR,2010-11,F,North Dakota State,Summit,29,934,162,332,122,243,40,89,80,100,17,89,106,64,21,13,52,75,444
5199,Rashad Whack,JR,2012-13,G,Mount St. Mary's,NEC,32,958,145,364,62,133,83,231,71,91,33,86,119,50,67,5,55,70,444
5200,Ken Williams,SR,2016-17,G,South Alabama,Sun Belt,32,941,141,392,91,205,50,187,112,144,19,74,93,106,27,7,61,52,444
5201,Wink Adams,SR,2008-09,G,Nevada-Las Vegas,MWC,31,987,146,389,107,244,39,145,112,165,22,106,128,87,43,1,63,48,443
5202,Francis Alonso,FR,2015-16,G,North Carolina-Greensboro,Southern,34,965,139,313,54,98,85,215,80,94,8,52,60,61,18,5,66,67,443
5203,Tim Ambrose,SO,2008-09,G,Albany (NY),AEC,31,753,167,364,140,284,27,80,82,105,48,111,159,80,35,3,96,91,443
5206,Stefan Blaszczynski,JR,2005-06,G,Nicholls State,Southland,27,860,157,328,131,236,26,92,103,142,58,129,187,57,29,9,76,83,443
5207,Courtney Bradley,JR,2005-06,F,Jacksonville State,OVC,29,879,170,328,151,278,19,50,84,122,61,158,219,29,38,9,53,57,443
5208,Anthony Brown,JR,2013-14,G,Stanford,Pac-12,36,1206,142,299,89,182,53,117,106,135,33,147,180,75,31,4,70,67,443
5209,Tasheed Carr,SR,2008-09,G,Saint Joseph's,A-10,31,1081,143,360,92,235,51,125,106,148,33,118,151,134,43,6,78,84,443
5210,Robert Carter,JR,2015-16,F,Maryland,Big Ten,36,950,170,307,144,229,26,78,77,103,61,189,250,67,30,45,79,102,443
5211,Brandon Cole,SR,2005-06,G,IUPUI,Mid-Cont,29,1100,153,366,72,155,81,211,56,75,51,152,203,37,28,6,43,45,443
5212,Darren Collison,SO,2006-07,G,UCLA,Pac-10,35,1155,149,312,98,198,51,114,94,116,11,68,79,199,78,3,102,53,443
5213,Troy Cotton,SR,2009-10,G,Green Bay,Horizon,35,1149,147,350,44,103,103,247,46,57,24,82,106,36,29,2,38,81,443
5214,Benson Egemonye,SR,2008-09,C,Niagara,MAAC,35,920,143,256,143,256,0,0,157,225,112,136,248,7,24,56,62,106,443
5215,Alex Francis,FR,2010-11,F,Bryant,NEC,30,927,170,335,170,328,0,7,103,198,80,159,239,24,27,16,112,82,443
5216,Kelly Golob,SR,2005-06,G,Northern Arizona,Big Sky,31,909,157,332,86,166,71,166,58,71,19,97,116,39,32,12,41,64,443
5217,Tyler Hagedorn,JR,2017-18,F,South Dakota,Summit,34,836,153,346,109,235,44,111,93,113,51,148,199,37,24,28,45,84,443
5218,DeAndre Hall,JR,2008-09,G,Texas Southern,SWAC,32,912,173,386,166,358,7,28,90,154,44,83,127,56,34,3,82,93,443
5219,Joe Harris ,SR,2013-14,G,Virginia,ACC,37,1066,149,338,77,158,72,180,73,114,22,87,109,84,35,8,48,88,443
5220,Jeremy Hemsley,FR,2015-16,G,San Diego State,MWC,37,1014,147,342,105,224,42,118,107,141,19,70,89,68,27,12,71,82,443
5221,LaDontae Henton,SO,2012-13,F,Providence,Big East,34,1162,158,392,127,272,31,120,96,118,90,192,282,34,34,21,68,92,443
5222,Jeremy Hollowell,JR,2015-16,F,Georgia State,Sun Belt,30,958,152,349,115,238,37,111,102,126,30,116,146,50,31,13,56,88,443
5223,Vander Joaquim,SR,2012-13,C,Hawaii,Big West,32,843,168,349,155,317,13,32,94,123,71,189,260,28,12,31,75,83,443
5224,Vic Law,SO,2016-17,F,Northwestern,Big Ten,36,1155,147,365,88,217,59,148,90,122,46,164,210,63,38,18,56,96,443
5225,Kareem Maddox,SR,2010-11,F,Princeton,Ivy,32,991,158,278,157,271,1,7,126,161,62,162,224,80,27,56,65,67,443
5228,Fletcher Magee,FR,2015-16,G,Wofford,Southern,32,921,133,282,42,92,91,190,86,93,12,85,97,47,12,3,47,49,443
5229,Malik Moore,SR,2018-19,F,South Carolina Upstate,Big South,28,808,156,340,112,192,44,148,87,124,50,143,193,63,39,19,67,79,443
5230,Wen Mukubu,SR,2006-07,G,Alabama-Birmingham,CUSA,31,1094,147,351,89,206,58,145,91,138,42,136,178,76,44,11,93,79,443
5231,Adam Smith,JR,2014-15,C,Virginia Tech,ACC,33,986,158,361,77,170,81,191,46,62,14,71,85,30,12,4,26,54,443
5232,Michael Southall,SR,2005-06,C,Louisiana,Sun Belt,28,843,164,266,164,265,0,1,115,177,66,157,223,41,27,93,59,95,443
5233,Elijah Stewart,JR,2016-17,G,Southern California,Pac-12,36,1073,154,357,76,155,78,202,57,81,45,96,141,43,29,42,37,94,443
5234,Reyshawn Terry,JR,2005-06,F,North Carolina,ACC,31,750,145,306,100,188,45,118,108,135,60,132,192,42,30,27,82,93,443
5235,Anthony Tolliver,SR,2006-07,C,Creighton,MVC,33,1044,158,312,154,293,4,19,123,187,74,146,220,64,24,57,67,102,443
5236,Christian Watford,SR,2012-13,F,Indiana,Big Ten,36,1007,127,295,67,170,60,125,129,159,48,178,226,31,23,17,57,81,443
5237,Micah Williams,JR,2009-10,G,East Tennessee State,A-Sun,35,936,148,314,107,197,41,117,106,147,37,80,117,33,27,15,68,71,443
5238,Pendarvis Williams,JR,2012-13,G,Norfolk State,MEAC,31,1025,143,316,78,156,65,160,92,113,30,109,139,53,34,18,38,53,443
5239,Anton Wilson,SR,2015-16,G,Detroit Mercy,Horizon,31,1001,137,314,51,113,86,201,83,93,28,94,122,68,41,19,54,91,443
5240,Keith Wright,JR,2010-11,F,Harvard,Ivy,30,968,174,298,174,297,0,1,95,134,96,153,249,46,25,51,69,74,443
5241,Alexis Yetna,SO,2018-19,F,South Florida,AAC,36,1088,165,306,137,230,28,76,85,136,118,228,346,36,30,21,59,91,443
5242,Bashir Ahmed,JR,2016-17,G,St. John's (NY),Big East,33,881,142,360,90,213,52,147,106,156,59,121,180,40,18,19,75,83,442
5243,James Akinjo,FR,2018-19,G,Georgetown,Big East,33,1043,128,351,76,218,52,133,134,165,7,89,96,173,37,1,99,81,442
5244,Jarrett Allen,FR,2016-17,F,Texas,Big 12,33,1061,179,316,179,309,0,7,84,149,100,178,278,27,19,51,84,68,442
5245,Chris Anderson,SR,2013-14,C,Louisiana Tech,CUSA,37,874,160,367,128,261,32,106,90,138,81,127,208,36,42,12,70,122,442
5246,Derrell Armstrong,SR,2012-13,G,North Carolina-Greensboro,Southern,30,816,158,346,117,236,41,110,85,118,43,105,148,63,39,4,74,75,442
5247,Dedrick Basile,SR,2016-17,G,Cal State Bakersfield,WAC,35,1042,165,376,100,208,65,168,47,68,23,88,111,106,56,3,73,85,442
5250,Paris Bass,SO,2015-16,G,Detroit Mercy,Horizon,24,714,159,342,137,274,22,68,102,149,50,141,191,50,33,33,81,84,442
5251,Ray Bowles,JR,2016-17,F,Pacific,WCC,33,1107,141,397,95,251,46,146,114,162,35,88,123,89,26,10,72,88,442
5252,Anthony Brown,SO,2006-07,F,Pacific,Big West,31,1032,149,279,148,276,1,3,143,204,72,152,224,49,24,21,69,75,442
5253,Jay Canty,SO,2012-13,F,Appalachian State,Southern,31,982,162,368,147,308,15,60,103,149,68,123,191,94,31,15,79,56,442
5254,Akeim Claborn,SR,2005-06,F,Alabama State,SWAC,30,851,150,292,129,224,21,68,121,197,83,143,226,34,24,22,57,113,442
5255,Mike Cunningham,SO,2016-17,G,South Carolina Upstate,A-Sun,33,1041,145,360,70,165,75,195,77,94,15,66,81,103,44,1,49,40,442
5256,Jermareo Davidson,JR,2005-06,F,Alabama,SEC,31,1048,168,352,168,349,0,3,106,142,86,190,276,38,26,58,67,68,442
5257,Ayo Dosunmu,FR,2018-19,G,Illinois,Big Ten,32,1000,163,375,113,233,50,142,66,95,23,105,128,104,41,8,72,64,442
5258,Devon Dotson,FR,2018-19,G,Kansas,Big 12,36,1168,147,305,114,214,33,91,115,147,22,110,132,127,49,5,81,91,442
5259,Bryan Dougher,SO,2009-10,G,Stony Brook,AEC,32,1011,146,352,51,128,95,224,55,67,27,60,87,57,31,2,43,63,442
5260,Ernie Duncan,SR,2018-19,G,Vermont,AEC,32,946,142,297,63,117,79,180,79,95,7,48,55,65,21,8,47,60,442
5261,Festus Ezeli,JR,2010-11,C,Vanderbilt,SEC,34,799,151,257,151,257,0,0,140,216,95,118,213,6,20,88,60,104,442
5262,Darien Fernandez,SR,2016-17,G,Jacksonville,A-Sun,33,975,134,334,77,184,57,150,117,158,35,110,145,123,79,2,81,116,442
5263,Tarvin Gaines,Sr,2012-13,F,Jacksonville State,OVC,27,856,139,293,110,202,29,91,135,162,46,94,140,23,27,19,41,75,442
5264,Dan Geriot,SO,2007-08,C,Richmond,A-10,31,909,165,349,134,271,31,78,81,108,45,126,171,56,22,10,78,94,442
5265,Dorian Green,SR,2012-13,G,Colorado State,MWC,34,1115,135,325,82,178,53,147,119,152,6,81,87,124,27,4,60,59,442
5266,Vernon Hamilton,SR,2006-07,G,Clemson,ACC,36,1133,178,380,141,259,37,121,49,100,25,88,113,122,70,3,95,58,442
5267,Luke Hancock,SR,2013-14,F,Louisville,AAC,36,861,124,304,56,107,68,197,126,152,22,73,95,79,36,7,53,95,442
5268,Troy Harper,SR,2018-19,G,Drexel,CAA,28,844,130,334,107,241,23,93,159,205,10,79,89,65,16,2,72,68,442
5269,Samajae Haynes-Jones,SR,2018-19,G,Wichita State,AAC,37,1196,164,459,100,244,64,215,50,59,18,91,109,99,23,2,60,70,442
5272,LaVone Holland,SR,2017-18,G,Northern Kentucky,Horizon,32,969,147,357,90,193,57,164,91,108,17,116,133,140,34,7,82,74,442
5273,Al Horford,SO,2005-06,F,Florida,SEC,39,1011,177,291,177,289,0,2,88,144,86,209,295,77,40,68,74,97,442
5274,Keith Hornsby,JR,2014-15,G,Louisiana State,SEC,33,1172,156,370,84,187,72,183,58,74,20,118,138,69,37,16,47,52,442
5275,Yassin Idbihi,SR,2006-07,F,Buffalo,MAC,28,886,146,334,131,268,15,66,135,169,93,168,261,48,16,34,80,78,442
5276,Darius Johnson-Odom,SO,2009-10,G,Marquette,Big East,34,1009,152,334,79,180,73,154,65,96,16,74,90,81,30,6,68,77,442
5277,Carl Jones,SR,2012-13,G,Saint Joseph's,A-10,30,1024,143,351,80,179,63,172,93,138,10,70,80,79,27,6,60,37,442
5278,Jacques Jones,JR,2006-07,F,Texas Southern,SWAC,31,1065,164,355,162,333,2,22,112,154,85,114,199,54,38,22,93,96,442
5279,Jamie Jones,SR,2009-10,F,Portland State,Big Sky,32,926,180,309,180,309,0,0,82,111,99,146,245,31,23,75,45,87,442
5280,Lucky Jones,SR,2014-15,G,Robert Morris,NEC,31,924,135,346,75,165,60,181,112,142,43,141,184,43,42,12,73,82,442
5281,DJ Laster,JR,2017-18,F,Gardner-Webb,Big South,32,844,188,372,167,306,21,66,45,74,63,109,172,14,18,13,61,79,442
5282,J.R. Lynch,JR,2017-18,G,Hartford,AEC,33,1190,154,361,103,220,51,141,83,100,11,132,143,126,48,2,80,89,442
5283,Stephen McDowell,JR,2007-08,G,Chattanooga,Southern,31,1017,142,383,34,90,108,293,50,65,20,47,67,38,40,0,53,48,442
5284,Shonn Miller,SR,2015-16,F,Connecticut,AAC,36,924,170,297,161,273,9,24,93,116,44,142,186,20,34,31,22,108,442
5285,Vado Morse,FR,2018-19,G,Mount St. Mary's,NEC,30,923,141,338,83,175,58,163,102,131,13,64,77,87,32,1,72,68,442
5286,Mike Morsell,JR,2016-17,G,Towson,CAA,33,896,140,323,92,179,48,144,114,149,33,68,101,43,27,19,69,81,442
5287,De'Sean Parsons,SR,2016-17,F,Portland State,Big Sky,31,905,167,346,151,295,16,51,92,174,56,137,193,83,41,22,89,66,442
5288,Josh Peppers,SR,2006-07,F,Central Florida,CUSA,31,912,150,330,95,185,55,145,87,115,45,96,141,60,28,16,72,69,442
5289,Bryquis Perine,JR,2009-10,G,Green Bay,Horizon,33,1107,152,376,120,280,32,96,106,138,15,74,89,138,37,6,76,47,442
5290,Jabari Peters,JR,2013-14,G,Sam Houston State,Southland,35,1113,115,300,65,172,50,128,162,236,29,130,159,147,44,13,81,59,442
5291,"Ed Polite, Jr.",SR,2018-19,F,Radford,Big South,33,1104,163,316,137,235,26,81,90,121,78,236,314,52,49,40,54,73,442
5292,D.J. Richardson,SR,2012-13,G,Illinois,Big Ten,36,1218,142,391,59,133,83,258,75,92,25,114,139,58,48,6,50,71,442
5293,Daniel Ruffin,JR,2006-07,G,Bradley,MVC,32,1072,152,367,86,194,66,173,72,93,13,67,80,172,61,5,78,70,442
5294,Shay Shine,JR,2010-11,G,High Point,Big South,31,947,154,357,99,221,55,136,79,107,40,91,131,83,41,7,69,83,442
5295,Scoochie Smith,SR,2016-17,G,Dayton,A-10,32,1000,145,310,91,171,54,139,98,127,11,87,98,144,51,3,70,76,442
5296,Kareem South,JR,2018-19,G,Texas A&M-Corpus Christi,Southland,32,1045,155,375,104,236,51,139,81,98,57,107,164,64,40,2,46,72,442
5297,Maze Stallworth,SR,2009-10,F,Morehead State,OVC,35,1121,140,347,45,114,95,233,67,82,77,99,176,45,47,18,52,107,442
5298,Justice Sueing,FR,2017-18,F,University of California,Pac-12,32,1023,157,362,115,227,42,135,86,128,48,124,172,44,48,15,68,75,442
5299,D'Shon Taylor,JR,2014-15,G,Norfolk State,MEAC,34,1082,145,322,95,181,50,141,102,151,54,116,170,45,28,25,57,93,442
5300,Tahjai Teague,JR,2018-19,F,Ball State,MAC,33,932,174,317,161,267,13,50,81,121,64,183,247,41,44,29,70,102,442
5301,Pancake Thomas,SR,2016-17,G,Western Kentucky,CUSA,32,1112,149,358,73,167,76,191,68,87,23,83,106,82,28,1,42,47,442
5302,Tre'Shawn Thurman,JR,2016-17,F,Omaha,Summit,32,954,166,334,155,290,11,44,99,147,65,183,248,43,13,26,63,91,442
5303,Elston Turner,JR,2011-12,G,Texas A&M,Big 12,32,1080,150,369,80,189,70,180,72,91,9,106,115,72,31,7,67,54,442
5304,Alan Wiggins,SR,2006-07,F,San Francisco,WCC,31,965,155,297,152,277,3,20,129,175,71,151,222,47,28,46,76,108,442
5305,Akeem Williams,SR,2013-14,G,Massachusetts-Lowell,AEC,28,896,145,379,91,222,54,157,98,122,26,88,114,95,36,2,90,67,442
5306,Cassius Winston,SO,2017-18,G,Michigan State,Big Ten,35,985,143,282,68,131,75,151,81,90,7,111,118,241,23,2,87,69,442
5307,Derrick Alston,SO,2018-19,G,Boise State,MWC,33,920,145,299,89,153,56,146,95,116,21,108,129,37,13,13,48,65,441
5308,Kyan Anderson,SR,2014-15,G,Texas Christian,Big 12,33,1055,132,332,75,164,57,168,120,138,9,39,48,141,41,5,84,68,441
5309,Trae Anderson,SR,2015-16,G,Eastern Illinois,OVC,30,711,171,357,166,325,5,32,94,142,46,110,156,53,31,22,85,91,441
5310,Ryan Andino,JR,2016-17,G,Maryland-Eastern Shore,MEAC,34,1055,138,379,17,61,121,318,44,52,9,60,69,33,29,1,36,40,441
5311,Cedric Blossom,JR,2014-15,F,Morgan State,MEAC,31,1077,161,378,159,370,2,8,117,168,100,119,219,22,33,8,37,73,441
5314,Marshon Brooks,JR,2009-10,G,Providence,Big East,31,824,168,360,122,229,46,131,59,83,55,74,129,44,41,16,52,72,441
5315,Mike Brown,JR,2014-15,G,Western Carolina,Southern,32,1117,162,354,120,240,42,114,75,112,67,133,200,51,29,18,70,95,441
5316,Jordan Capps,SR,2017-18,F,Southeastern Louisiana,Southland,33,692,178,329,160,276,18,53,67,122,37,105,142,17,15,31,63,79,441
5317,Eli Carter,FR,2011-12,G,Rutgers,Big East,32,952,153,374,98,218,55,156,80,115,16,82,98,68,42,3,88,81,441
5318,Mike Conley,FR,2006-07,G,Ohio State,Big Ten,39,1231,160,309,139,240,21,69,100,144,27,107,134,238,87,10,86,60,441
5319,Pat Connaughton,JR,2013-14,G,Notre Dame,ACC,32,1190,155,343,79,142,76,201,55,66,38,189,227,95,33,18,35,57,441
5320,Troy Daniels,SR,2012-13,G,Virginia Commonwealth,A-10,36,947,149,357,25,49,124,308,19,27,23,89,112,23,32,3,32,76,441
5321,Cade Davis,SR,2010-11,G,Oklahoma,Big 12,31,1081,147,329,83,150,64,179,83,114,28,127,155,57,31,14,61,83,441
5322,Cameron Delaney,SR,2018-19,G,Sam Houston State,Southland,33,1041,145,311,68,134,77,177,74,90,52,129,181,66,30,15,52,69,441
5323,Daniel Emerson,JR,2008-09,F,Mercer,A-Sun,32,1118,146,307,126,250,20,57,129,186,119,224,343,72,14,5,102,80,441
5324,George Fant,SR,2014-15,F,Western Kentucky,CUSA,32,920,170,321,170,321,0,0,101,163,103,165,268,50,30,21,66,107,441
5325,Keith Gabriel,JR,2010-11,G,Virginia Military Institute,Big South,31,738,151,355,88,163,63,192,76,115,28,70,98,43,53,17,71,83,441
5326,Langston Galloway,JR,2012-13,G,Saint Joseph's,A-10,32,1142,150,362,70,159,80,203,61,79,22,94,116,72,44,11,47,74,441
5327,Sterling Gibbs,SR,2015-16,G,Connecticut,AAC,36,1186,125,323,46,119,79,204,112,131,11,67,78,83,34,1,58,57,441
5328,Ricardo Glenn,SR,2013-14,F,South Carolina Upstate,A-Sun,33,945,158,249,158,248,0,1,125,176,105,160,265,59,21,9,70,76,441
5329,A.J. Graves,SO,2005-06,G,Butler,Horizon,33,1070,148,368,80,186,68,182,77,94,6,69,75,80,43,1,54,65,441
5330,Isaac Haas,JR,2016-17,C,Purdue,Big Ten,35,682,159,271,159,271,0,0,123,173,62,112,174,20,9,26,78,73,441
5331,Alex Harris,SR,2014-15,G,Cal State Fullerton,Big West,28,897,147,354,112,231,35,123,112,167,12,99,111,98,41,4,77,54,441
5332,DeAndre Haynes,SR,2005-06,G,Kent State,MAC,34,1053,152,348,96,207,56,141,81,103,27,66,93,134,57,4,104,104,441
5333,Kyle Hittle,SO,2013-14,G,Incarnate Word,Southland,27,915,154,290,95,145,59,145,74,105,30,123,153,48,21,8,47,48,441
5336,Aaron Holiday,SO,2016-17,G,UCLA,Pac-12,36,952,150,309,97,180,53,129,88,111,12,91,103,158,39,6,87,81,441
5337,Jeremy Hollimon,SR,2016-17,G,Troy,Sun Belt,37,807,145,305,98,192,47,113,104,134,29,65,94,58,20,6,56,68,441
5338,Ian Hummer,SO,2010-11,F,Princeton,Ivy,32,965,180,324,180,324,0,0,81,126,62,154,216,61,36,36,70,66,441
5339,Michael Hunter,SR,2009-10,G,UC-Irvine,Big West,32,937,140,346,60,125,80,221,81,93,7,70,77,75,42,2,68,54,441
5340,Jarrod Jones,SR,2011-12,F,Ball State,MAC,30,935,161,334,148,299,13,35,106,138,69,192,261,24,21,24,51,68,441
5341,Jeremy Kelly,SR,2005-06,G,Tennessee-Martin,OVC,27,945,136,334,93,173,43,161,126,158,24,65,89,120,56,8,100,95,441
5342,D.J. Kennedy,SO,2008-09,G,St. John's (NY),Big East,34,1176,134,333,98,225,36,108,137,187,59,167,226,101,52,14,73,76,441
5343,John Konchar,FR,2015-16,G,Purdue-Fort Wayne,Summit,34,1211,163,279,134,213,29,66,86,119,91,221,312,92,71,9,51,81,441
5344,Bryant McIntosh,SO,2015-16,G,Northwestern,Big Ten,32,1142,161,381,112,247,49,134,70,85,12,104,116,213,31,5,78,65,441
5345,Darrius Morrow,JR,2010-11,F,East Carolina,CUSA,34,1038,141,277,141,276,0,1,159,239,87,126,213,26,25,28,80,95,441
5346,Jeffery Moss,SR,2015-16,F,Murray State,OVC,31,1106,146,336,66,143,80,193,69,88,28,97,125,63,23,3,40,70,441
5347,Jim Mower,SO,2009-10,G,Lafayette,Patriot,32,857,149,334,57,136,92,198,51,63,15,50,65,61,14,4,33,60,441
5348,Shabazz Napier,SO,2011-12,G,Connecticut,Big East,34,1191,136,350,77,184,59,166,110,148,23,97,120,198,56,9,94,87,441
5349,Ike Ofoegbu,SR,2006-07,F,Southern Methodist,CUSA,31,953,137,274,108,210,29,64,138,196,109,127,236,30,36,13,103,84,441
5350,A.J. Ogilvy,JR,2009-10,C,Vanderbilt,SEC,33,764,142,279,142,279,0,0,157,215,66,138,204,29,34,48,62,97,441
5351,Ashton Pankey,JR,2014-15,F,Manhattan,MAAC,33,908,145,274,145,274,0,0,151,217,77,143,220,31,23,47,76,120,441
5352,Darius Quisenberry,FR,2018-19,G,Youngstown State,Horizon,32,870,142,346,91,186,51,160,106,133,12,82,94,120,43,1,65,72,441
5353,Justin Robinson,SO,2014-15,G,Monmouth,MAAC,33,1062,139,331,87,190,52,141,111,140,21,92,113,120,56,0,64,48,441
5354,Jonathon Simmons,JR,2011-12,G,Houston,CUSA,30,902,154,301,122,218,32,83,101,141,42,107,149,65,21,11,100,75,441
5355,Jared Terrell,JR,2016-17,G,Rhode Island,A-10,35,1074,142,339,96,206,46,133,111,148,34,66,100,70,36,6,54,90,441
5358,Elijah Thomas,SR,2018-19,F,Clemson,ACC,34,874,172,281,172,280,0,1,97,152,84,181,265,46,28,74,94,112,441
5359,Jordan Washington,JR,2015-16,F,Iona,MAAC,31,579,167,325,167,325,0,0,107,180,95,103,198,11,14,18,66,116,441
5360,Bryson Williams,SO,2017-18,F,Fresno State,MWC,32,916,192,322,191,318,1,4,56,93,60,135,195,37,16,21,59,102,441
5361,J.T. Williams,SR,2005-06,F,McNeese State,Southland,28,838,147,342,81,177,66,165,81,107,50,105,155,35,47,22,64,82,441
5362,Josh Williams,SR,2016-17,G,Lipscomb,A-Sun,33,850,142,321,68,125,74,196,83,98,34,80,114,57,27,8,74,82,441
5363,Scott Wood,SR,2012-13,F,North Carolina State,ACC,35,1189,126,289,22,53,104,236,85,93,11,91,102,37,19,22,34,80,441
5364,Aaron Anderson,JR,2012-13,G,North Dakota,Big Sky,33,1055,126,290,73,161,53,129,135,157,19,91,110,109,45,2,56,44,440
5365,Manny Atkins,JR,2012-13,F,Georgia State,CAA,31,1111,148,350,94,219,54,131,90,113,59,148,207,69,48,9,67,71,440
5366,Sean Baptiste,JR,2008-09,G,Fairleigh Dickinson,NEC,27,967,154,361,106,221,48,140,84,120,59,100,159,29,47,4,56,61,440
5367,Javon Bess,JR,2017-18,G,Saint Louis,A-10,33,1195,128,324,104,235,24,89,160,211,79,165,244,72,41,13,67,78,440
5368,Jenirro Bush,JR,2010-11,G,Jackson State,SWAC,31,846,153,355,101,201,52,154,82,124,32,75,107,32,42,4,61,63,440
5369,Jalen Cannon,SO,2012-13,F,St. Francis (NY),NEC,30,910,170,306,164,282,6,24,94,138,104,161,265,20,30,11,43,66,440
5370,Josh Carter,JR,2007-08,F,Texas A&M,Big 12,36,1041,146,347,67,139,79,208,69,84,37,105,142,50,21,6,28,56,440
5371,Bill Clark,SO,2008-09,G,Duquesne,A-10,34,1004,141,286,75,120,66,166,92,135,54,117,171,91,32,7,84,121,440
5372,David Cohn,SR,2017-18,G,William & Mary,CAA,31,1114,144,272,95,157,49,115,103,113,9,83,92,207,50,0,83,59,440
5373,Glenn Cosey,JR,2012-13,G,Eastern Kentucky,OVC,29,1026,141,330,61,132,80,198,78,96,11,84,95,93,47,0,39,52,440
5374,David Crisp,SR,2018-19,G,Washington,Pac-12,36,1190,150,366,76,168,74,198,66,103,15,61,76,97,36,2,71,78,440
5375,Doug Davis,SR,2011-12,G,Princeton,Ivy,32,1057,155,365,72,167,83,198,47,57,8,53,61,45,37,9,42,46,440
5376,Terence Davis,JR,2017-18,G,Mississippi,SEC,32,874,157,386,98,200,59,186,67,93,47,151,198,66,29,28,72,94,440
5377,Will Davis,SR,2014-15,F,UC-Irvine,Big West,34,1012,185,341,185,340,0,1,70,99,83,157,240,33,18,34,45,47,440
5380,Kevin Dillard,JR,2011-12,G,Dayton,A-10,33,1079,143,347,104,227,39,120,115,139,10,79,89,198,47,13,94,89,440
5381,Vince Edwards,JR,2016-17,F,Purdue,Big Ten,35,1001,160,329,113,218,47,111,73,89,66,107,173,112,20,19,58,64,440
5382,Wes Eikmeier,SR,2012-13,G,Colorado State,MWC,35,1084,145,381,91,232,54,149,96,107,3,56,59,75,19,2,59,97,440
5383,Tyler Ennis,FR,2013-14,G,Syracuse,ACC,34,1215,148,360,118,275,30,85,114,149,27,88,115,187,71,6,58,69,440
5384,Will Felder,SR,2013-14,F,Miami (OH),MAC,31,990,161,301,156,275,5,26,113,135,65,144,209,28,25,31,70,73,440
5385,Corey Fisher,JR,2009-10,G,Villanova,Big East,33,892,134,300,96,204,38,96,134,174,24,70,94,129,42,6,68,83,440
5386,Terry Henderson,SR,2016-17,G,North Carolina State,ACC,32,988,136,314,58,111,78,203,90,117,22,77,99,51,22,18,51,76,440
5387,Brian Hodges,JR,2006-07,G,Maryland-Baltimore County,AEC,30,809,157,400,101,237,56,163,70,92,34,75,109,32,19,2,57,58,440
5388,Will Hudson,SR,2010-11,F,Oakland,Summit,35,1097,160,248,160,242,0,6,120,168,133,120,253,28,24,33,46,88,440
5389,DeWayne Jackson,SR,2012-13,F,Morgan State,MEAC,32,1027,160,359,121,219,39,140,81,123,47,131,178,79,53,29,76,88,440
5390,Wesley Jenkins,SO,2008-09,G,Saint Peter's,MAAC,28,953,151,427,80,234,71,193,67,93,25,95,120,29,57,4,63,57,440
5391,Kenny McGowan,SR,2011-12,G,Idaho State,Big Sky,30,885,136,359,69,153,67,206,101,129,12,30,42,66,28,2,71,96,440
5392,Erik Murphy,SR,2012-13,F,Florida,SEC,36,952,164,318,92,159,72,159,40,51,58,141,199,50,23,25,51,101,440
5393,Devin Oliver,SR,2013-14,F,Dayton,A-10,37,1107,149,308,107,202,42,106,100,131,84,191,275,86,33,10,53,93,440
5394,Kevin Pangos,SR,2014-15,G,Gonzaga,WCC,38,1278,135,301,54,113,81,188,89,108,16,88,104,181,48,4,51,74,440
5395,Chris Perez,SR,2013-14,G,Canisius,MAAC,34,1192,161,364,135,293,26,71,92,131,37,58,95,58,26,1,72,79,440
5396,Angel Rodriguez,SR,2015-16,G,Miami (FL),ACC,35,1055,144,326,88,162,56,164,96,120,23,66,89,158,58,6,89,90,440
5397,Augustine Rubit,SO,2011-12,F,South Alabama,Sun Belt,29,938,159,314,159,308,0,6,122,171,105,163,268,24,11,26,67,60,440
5398,Tyler Scanlon,JR,2018-19,F,Boston University,Patriot,32,1070,165,357,115,211,50,146,60,75,28,131,159,106,44,5,72,49,440
5399,Justin Sears,SR,2015-16,F,Yale,Ivy,28,869,163,310,158,294,5,16,109,163,103,107,210,79,21,48,69,78,440
5400,Jarred Shaw,JR,2012-13,F,Utah State,WAC,31,907,179,332,178,327,1,5,81,112,69,192,261,25,9,30,65,91,440
5401,TJ Shorts II,SR,2018-19,G,UC-Davis,Big West,29,960,163,328,151,285,12,43,102,142,18,119,137,126,46,6,88,73,440
5402,Chet Stachitas,SR,2005-06,G,Saint Joseph's,A-10,33,1149,135,330,60,145,75,185,95,118,19,65,84,73,39,7,49,78,440
5403,Will Thomas,JR,2006-07,F,George Mason,CAA,33,1147,178,284,178,283,0,1,84,135,66,161,227,73,21,21,52,45,440
5404,Bernard Thompson,SR,2014-15,G,Florida Gulf Coast,A-Sun,32,1031,151,383,77,187,74,196,64,87,46,114,160,56,55,4,50,66,440
5405,Wyatt Walker,SO,2016-17,C,Samford,Southern,34,991,157,268,155,262,2,6,124,163,99,230,329,51,21,29,67,88,440
5406,Marquis Weddle,SO,2008-09,G,Tennessee-Martin,OVC,32,936,156,434,63,161,93,273,35,44,10,47,57,27,25,0,53,45,440
5407,D.J. White,JR,2006-07,F,Indiana,Big Ten,32,1017,170,332,170,332,0,0,100,146,77,157,234,40,28,73,62,84,440
5408,Matthew Wilson,JR,2018-19,F,Army,Patriot,32,847,187,319,187,319,0,0,66,107,58,218,276,14,9,8,47,70,440
5409,Andre Wolford,JR,2017-18,G,Saint Francis (PA),NEC,31,899,141,280,44,84,97,196,61,72,16,77,93,25,16,3,24,56,440
5410,Jalen Adams,SR,2018-19,G,Connecticut,AAC,26,781,169,347,126,226,43,121,58,70,24,80,104,88,28,8,72,67,439
5411,Jordan Barnett,SR,2017-18,F,Missouri,SEC,32,1091,142,316,60,118,82,198,73,82,50,139,189,35,23,19,50,51,439
5412,Matt Bell,SR,2006-07,G,Army,Patriot,30,920,134,282,91,196,43,86,128,161,13,89,102,63,22,2,71,36,439
5413,Trae Bell-Haynes,SO,2015-16,G,Vermont,AEC,36,995,135,286,109,220,26,66,143,179,16,80,96,126,41,2,98,87,439
5414,Takais Brown,JR,2006-07,F,Georgia,SEC,31,876,181,320,179,315,2,5,75,109,104,70,174,27,17,16,68,59,439
5415,Dan Coleman,JR,2006-07,F,Minnesota,Big Ten,31,1003,169,374,150,306,19,68,82,106,52,133,185,42,21,41,57,74,439
5416,Kyle Davis,JR,2015-16,F,Brigham Young,WCC,37,1001,175,321,168,306,7,15,82,136,85,191,276,46,26,49,69,92,439
5417,Malcolm Drumwright,JR,2016-17,G,Jacksonville State,OVC,35,1160,155,372,92,196,63,176,66,83,9,74,83,135,21,8,86,95,439
5418,Phil Forte,SR,2016-17,G,Oklahoma State,Big 12,33,1028,135,316,50,112,85,204,84,88,23,62,85,49,37,2,33,50,439
5419,Alex Franklin,SO,2007-08,F,Siena,MAAC,29,855,158,278,158,278,0,0,123,186,74,152,226,33,46,23,57,85,439
5422,Branden Frazier,JR,2012-13,G,Fordham,A-10,31,1085,130,377,86,218,44,159,135,163,31,84,115,154,28,1,94,66,439
5423,Trent Frazier,SO,2018-19,G,Illinois,Big Ten,32,975,148,360,68,163,80,197,63,83,10,65,75,82,44,1,65,74,439
5424,Tyrece Gibbs,SR,2008-09,G,New Hampshire,AEC,30,1017,148,373,61,152,87,221,56,78,20,116,136,70,20,25,82,61,439
5425,Gary Harris,FR,2012-13,G,Michigan State,Big Ten,34,1010,150,329,85,171,65,158,74,98,30,56,86,46,45,6,51,68,439
5426,Matt Howard,JR,2009-10,F,Butler,Horizon,38,959,129,268,126,257,3,11,178,227,68,128,196,30,22,23,60,133,439
5427,Justin Jaworski,SO,2018-19,G,Lafayette,Patriot,30,919,142,281,57,107,85,174,70,81,16,70,86,81,20,1,59,61,439
5428,Ryan Kemrite,JR,2016-17,G,Liberty,Big South,33,1037,130,267,49,75,81,192,98,116,17,71,88,28,31,3,24,85,439
5429,Gerald Lee,SO,2007-08,C,Old Dominion,CAA,34,1041,168,349,165,338,3,11,100,136,91,106,197,48,16,30,64,78,439
5430,James Mays,JR,2006-07,C,Clemson,ACC,36,1014,172,360,165,329,7,31,88,160,98,134,232,95,69,34,101,81,439
5431,Gerald McLemore,SO,2009-10,G,Maine,AEC,30,1040,144,359,42,103,102,256,49,66,9,72,81,40,30,6,56,58,439
5432,Lorenzo Miles,SR,2006-07,G,Niagara,MAAC,34,1167,138,356,77,177,61,179,102,144,34,84,118,120,40,1,76,87,439
5433,Robert Mitchell,JR,2008-09,F,Seton Hall,Big East,30,1084,169,406,137,304,32,102,69,93,76,163,239,50,37,25,68,93,439
5434,Austin Montgomery,SR,2007-08,G,IUPUI,Summit,32,967,150,316,78,146,72,170,67,76,22,76,98,51,33,11,56,69,439
5435,Obi Muonelo,SR,2009-10,G,Oklahoma State,Big 12,33,1010,148,342,68,154,80,188,63,107,38,128,166,78,31,9,65,66,439
5436,Bubba Parham,FR,2017-18,G,Virginia Military Institute,Southern,30,895,145,363,87,188,58,175,91,114,12,89,101,74,24,0,83,67,439
5437,Anthony Register,SR,2005-06,G,Stetson,A-Sun,32,1073,140,356,95,218,45,138,114,137,26,87,113,56,64,0,75,57,439
5438,Travis Releford,SR,2012-13,G,Kansas,Big 12,37,1252,155,270,116,176,39,94,90,114,43,99,142,95,47,9,59,73,439
5439,Justin Robinson,JR,2009-10,G,Rider,MAAC,33,1084,146,346,82,203,64,143,83,94,18,97,115,91,48,5,57,84,439
5440,Robert Sacre,JR,2010-11,C,Gonzaga,WCC,35,906,138,283,138,282,0,1,163,198,86,136,222,40,27,66,75,94,439
5441,Jherrod Stiggers,JR,2014-15,G,Houston,AAC,31,1105,139,384,43,104,96,280,65,85,17,96,113,79,37,10,89,54,439
5444,Paul Stoll,SR,2007-08,G,Texas-Rio Grande Valley,Ind,31,1026,108,222,22,41,86,181,137,161,6,75,81,224,79,4,109,82,439
5445,Omar Strong,JR,2011-12,G,Texas Southern,SWAC,33,1012,135,347,33,85,102,262,67,78,15,63,78,53,32,2,69,72,439
5446,Kammron Taylor,JR,2005-06,G,Wisconsin,Big Ten,31,1064,140,364,73,196,67,168,92,111,18,74,92,73,24,3,81,58,439
5447,Marc Trasolini,SO,2009-10,F,Santa Clara,WCC,32,936,149,280,130,226,19,54,122,156,66,129,195,20,22,50,56,89,439
5448,Nick Ward,JR,2018-19,F,Michigan State,Big Ten,34,708,163,281,161,279,2,2,111,170,59,147,206,23,11,42,69,84,439
5449,Desmond Washington,SO,2012-13,G,Saint Peter's,MAAC,30,1033,146,392,65,173,81,219,66,75,16,86,102,31,41,3,49,62,439
5450,Kevin Zabo,SR,2017-18,G,Kent State,MAC,34,980,155,369,111,232,44,137,85,108,19,89,108,82,36,2,63,97,439
5451,Joe Zeglinski,SR,2010-11,G,Hartford,AEC,31,1116,143,427,53,150,90,277,63,98,42,83,125,58,36,7,60,79,439
5452,Martin Zeno,SO,2005-06,G,Texas Tech,Big 12,32,1127,161,344,156,327,5,17,112,154,49,122,171,91,45,13,79,70,439
5453,Shizz Alston Jr.,JR,2017-18,G,Temple,AAC,33,1111,157,392,86,213,71,179,53,59,22,82,104,102,26,1,52,53,438
5454,James Anderson,FR,2007-08,G,Oklahoma State,Big 12,33,1021,148,340,81,163,67,177,75,105,56,67,123,35,26,16,65,41,438
5455,Anthony Banks,SO,2010-11,F,Florida Gulf Coast,A-Sun,30,926,164,335,164,333,0,2,110,155,106,85,191,26,23,13,73,78,438
5456,Brett Bisping,SO,2013-14,F,Siena,MAAC,38,1023,156,302,144,264,12,38,114,151,98,150,248,29,23,35,50,131,438
5457,LaVell Boyd,JR,2015-16,G,Missouri-Kansas City,WAC,31,1014,149,345,68,152,81,193,59,73,13,92,105,70,24,4,45,78,438
5458,Brandon Brooks,SR,2008-09,G,Alabama State,SWAC,32,1137,143,285,119,220,24,65,128,166,24,110,134,212,43,10,105,63,438
5459,Anthony Campbell,SR,2012-13,F,Austin Peay,OVC,30,930,149,324,85,153,64,171,76,88,35,111,146,58,25,0,72,39,438
5460,Jordan Chatman,JR,2017-18,G,Boston College,ACC,34,1250,140,337,53,117,87,220,71,79,16,84,100,54,22,1,28,58,438
5461,Simon Conn,SR,2005-06,C,Gardner-Webb,A-Sun,29,945,187,330,186,324,1,6,63,86,95,149,244,50,18,70,69,77,438
5462,Vincent Council,SO,2010-11,G,Providence,Big East,32,1160,140,393,93,254,47,139,111,154,40,95,135,189,55,14,106,77,438
5463,Michael Craion,JR,2009-10,F,Oral Roberts,Summit,33,1028,166,327,163,312,3,15,103,162,82,160,242,52,42,32,75,93,438
5466,Scott Cutley,SR,2007-08,F,Cal State Fullerton,Big West,30,987,175,339,164,304,11,35,77,127,65,158,223,85,37,6,77,61,438
5467,Tyler Davis,SO,2016-17,C,Texas A&M,SEC,31,812,166,269,166,268,0,1,106,153,95,121,216,44,15,29,83,82,438
5468,Deki Delic,SR,2006-07,F,Monmouth,NEC,30,961,149,334,69,124,80,210,60,102,20,85,105,63,18,7,65,72,438
5469,Nicchaeus Doaks,JR,2007-08,F,Chattanooga,Southern,31,860,164,279,146,229,18,50,92,137,66,153,219,45,26,36,71,61,438
5470,Chris Flores,FR,2009-10,G,NJIT,GWC,31,935,151,359,93,205,58,154,78,115,34,88,122,69,55,1,59,81,438
5471,Ramon Galloway,JR,2011-12,G,La Salle,A-10,31,1033,154,337,86,183,68,154,62,79,17,127,144,108,47,8,94,73,438
5472,Jonathan Gibson,JR,2008-09,G,New Mexico State,WAC,31,934,149,350,84,182,65,168,75,109,7,52,59,65,44,1,61,77,438
5473,JaMychal Green,SO,2009-10,F,Alabama,SEC,31,837,162,327,162,322,0,5,114,164,86,136,222,33,27,52,79,97,438
5474,Ashley Hamilton,SR,2012-13,F,Loyola Marymount,WCC,34,1098,142,367,114,285,28,82,126,172,75,168,243,48,35,14,106,97,438
5475,Desmar Jackson,SO,2010-11,G,Wyoming,MWC,30,893,151,340,126,251,25,89,111,147,39,108,147,64,61,17,101,88,438
5476,Marcus Johnson Jr.,JR,2015-16,G,Little Rock,Sun Belt,35,1072,140,296,65,135,75,161,83,106,21,87,108,54,27,0,47,39,438
5477,James Johnson,FR,2007-08,F,Wake Forest,ACC,30,875,164,337,136,237,28,100,82,119,93,151,244,37,41,40,78,93,438
5478,Travele Jones,JR,2009-10,F,Texas Southern,SWAC,32,1034,147,311,123,226,24,85,120,204,51,137,188,44,56,26,106,72,438
5479,Rysheed Jordan,SO,2014-15,G,St. John's (NY),Big East,31,952,143,329,100,211,43,118,109,166,37,77,114,95,54,10,93,82,438
5480,Terrence Joyner,SR,2011-12,G,Mississippi Valley State,SWAC,34,1077,147,363,78,175,69,188,75,123,44,71,115,88,43,3,74,90,438
5481,Evan Kelley,SR,2014-15,G,Sacred Heart,NEC,32,999,172,375,161,326,11,49,83,136,30,99,129,76,38,7,68,62,438
5482,Andrew Lovedale,SR,2008-09,F,Davidson,Southern,35,1060,185,367,185,367,0,0,68,115,99,207,306,23,31,54,59,91,438
5483,Tommy Mason-Griffin,FR,2009-10,G,Oklahoma,Big 12,31,1107,147,369,77,204,70,165,74,91,15,74,89,154,28,0,87,41,438
5484,Kellen McCoy,SR,2008-09,G,Weber State,Big Sky,31,976,134,281,74,144,60,137,110,136,20,91,111,85,41,1,91,67,438
5485,Lorenzo Miles,JR,2005-06,G,Niagara,MAAC,29,1075,134,347,61,161,73,186,97,130,31,81,112,97,38,7,84,69,438
5488,Kenny Moore,JR,2010-11,F,Tennessee State,OVC,30,872,137,298,101,210,36,88,128,165,72,134,206,56,42,12,87,93,438
5489,Davide Moretti,SO,2018-19,G,Texas Tech,Big 12,38,1199,134,269,61,110,73,159,97,105,3,76,79,91,42,0,50,84,438
5490,Laurynas Motuzis,JR,2017-18,G,American,Patriot,30,1083,155,373,92,183,63,190,65,102,22,121,143,50,49,7,66,85,438
5491,Miye Oni,SO,2017-18,G,Yale,Ivy,29,952,156,385,99,201,57,184,69,92,26,147,173,105,27,22,81,82,438
5492,Miguel Paul,JR,2012-13,G,East Carolina,CUSA,33,1093,118,319,59,146,59,173,143,164,8,64,72,236,49,5,120,87,438
5493,David Perez,SO,2009-10,G,Centenary (LA),Summit,29,841,138,322,73,157,65,165,97,115,22,53,75,54,29,0,53,56,438
5494,Corey Petros,JR,2013-14,C,Oakland,Horizon,33,1171,182,316,182,316,0,0,74,145,102,170,272,50,16,14,48,72,438
5495,Nate Pierre-Louis,SO,2018-19,G,Temple,AAC,33,1132,153,333,127,249,26,84,106,159,43,149,192,69,53,10,56,75,438
5496,Giddy Potts,SR,2017-18,G,Middle Tennessee,CUSA,33,1051,142,343,57,133,85,210,69,80,15,126,141,63,45,8,54,85,438
5497,Darion Rackley,SR,2014-15,G,Jacksonville State,OVC,29,941,120,338,80,195,40,143,158,211,29,83,112,62,41,7,77,60,438
5498,Alex Robinson,SO,2016-17,G,Texas Christian,Big 12,39,1283,164,391,125,274,39,117,71,112,18,104,122,228,59,20,107,73,438
5499,Tony Snell,JR,2012-13,G,New Mexico,MWC,35,1093,144,341,80,177,64,164,86,102,14,78,92,101,29,17,72,46,438
5500,Jackson Stevenett,JR,2011-12,F,Southern Utah,Summit,31,1008,166,324,157,297,9,27,97,128,60,116,176,47,21,22,64,86,438
5501,Marcus Stout,SR,2007-08,G,Fordham,A-10,29,975,152,379,79,169,73,210,61,84,19,52,71,85,29,0,69,76,438
5502,D'Shon Taylor,SR,2015-16,G,Norfolk State,MEAC,33,946,147,327,103,203,44,124,100,130,57,118,175,51,38,20,63,86,438
5503,Jeffery Taylor,FR,2009-10,F,Vanderbilt,SEC,33,883,148,300,147,289,1,11,141,189,64,108,172,57,36,13,74,87,438
5504,Junior Treasure,JR,2009-10,G,Texas Southern,SWAC,30,834,136,341,83,165,53,176,113,146,12,63,75,87,55,3,101,93,438
5505,Ladarious Weaver,JR,2006-07,G,Tennessee State,OVC,32,1101,155,387,62,131,93,256,35,48,20,69,89,56,37,3,44,69,438
5506,Devonta White,SO,2011-12,G,Georgia State,CAA,34,1165,148,378,94,221,54,157,88,106,19,57,76,100,60,2,67,73,438
5507,Isaac Williams,SR,2016-17,G,Mississippi Valley State,SWAC,32,916,157,395,91,209,66,186,58,70,40,75,115,29,28,4,23,65,438
